Name,Latitude,Longitude,Free Bikes,Empty Slots,Total Bikes
Chester Ave & 12 Ave,40.644367,-73.984276,8,12,20
W 56 St & 8 Ave,40.765959181657976,-73.98313522338867,1,38,39
S Portland Ave & Hanson Pl,40.68539567,-73.97431458,7,18,25
E 78 St & 2 Ave,40.7727966,-73.95577801,14,8,22
87 St & Roosevelt Ave,40.74825,-73.87936,3,20,23
E 157 St & River Ave,40.825737,-73.927311,11,6,17
E 17 St & Broadway,40.737006,-73.990134,11,66,77
Central Ave & Flushing Ave,40.702831,-73.9333,14,4,18
E 149 St & Eagle Ave,40.814046,-73.91186,3,16,19
E 165 St & Jerome Ave,40.83263,-73.925101,14,4,18
72 St & 31 Ave,40.7584,-73.89531,11,7,18
Irwin Ave & W 232 St,40.88227,-73.90809,12,4,16
Nassau Ave & Russell St,40.72557,-73.94434,38,12,50
1 St & 6 Ave,40.672784,-73.979826,27,7,34
Bulova Ave & Brooklyn Queens Expressway W,40.762507,-73.902534,9,8,17
45 St & 4 Ave,40.649145,-74.009486,11,9,20
Watts St & Greenwich St,40.72405549,-74.00965965,20,14,34
Broadway & E 14 St,40.73454567,-73.99074142,6,97,103
Harrison Pl & Porter Ave,40.70686,-73.92851,20,0,20
W 87 St & West End Ave,40.789622,-73.97757,12,33,45
3 Ave & E 109 St,40.79338,-73.94329,23,0,23
Myrtle Ave & St Edwards St,40.69327018,-73.97703874,49,5,54
E 9 St & Ave C,40.72521311,-73.97768752,46,1,47
Marcy Ave & Gates Ave,40.686679,-73.947417,17,0,17
Beverley Rd & Flatbush Ave,40.64499,-73.95818,24,0,24
Bergen St & Vanderbilt Ave,40.6794388,-73.9680438,9,15,24
E 149 St & Park Ave,40.818154,-73.925294,7,17,24
Sheridan Ave & E 168 St,40.835334,-73.9154,0,18,18
Dyckman St & Henshaw St,40.867357,-73.92936,18,0,18
Hudson St & Reade St,40.71625008,-74.0091059,17,38,55
E 106 St & 1 Ave,40.7892529,-73.93956237,18,4,22
E 1 St & Bowery,40.72486122254819,-73.99213135242462,27,13,40
DeKalb Ave & Franklin Ave,40.69064807082943,-73.95746178925037,14,1,15
Melrose Ave & E 150 St,40.816827,-73.917338,11,13,24
Botanical Sq & Webster Ave,40.86814,-73.88145,29,0,29
E 23 St & 1 Ave,40.736502,-73.97809472,19,4,23
Buchanan Pl & Grand Ave,40.85834,-73.90626,8,11,19
Flatbush Ave & Ocean Ave,40.663657,-73.963014,7,24,31
Halsey St & Evergreen Ave,40.68858,-73.91227,8,12,20
Southern Blvd & E 174 St,40.836733,-73.887931,13,13,26
Park Pl & Church St,40.71334184275907,-74.00935515761375,17,36,53
Kent Ave & N 7 St,40.72036775298455,-73.96165072917938,47,0,47
E 188 St & Creston Ave,40.861669,-73.898589,8,23,31
63 St & 59 Dr,40.71832,-73.90128,22,1,23
Decatur Ave & E 197 St,40.86557,-73.88807,18,0,18
E 94 St & Madison Ave,40.785851052913884,-73.95482444378061,25,16,41
55 Ave & 90 St,40.73676,-73.87318,8,9,17
Vernon Blvd & 41 Rd,40.7552433,-73.9485678,12,15,27
South St & Whitehall St,40.70122128,-74.01234218,45,3,48
21 St & Queens Plaza North,40.75325964,-73.94335788,10,22,32
Bronx Park S & Bryant Ave,40.84437,-73.87796,16,2,18
E 34 St & Linden Blvd,40.65302,-73.94599,5,17,22
Liberty St & Broadway,40.70905623,-74.01043382,6,57,63
Frost St & Debevoise Ave,40.71882,-73.93948,10,11,21
3 Ave & Schermerhorn St,40.68683208,-73.9796772,16,12,28
Franklin Ave & St Marks Ave,40.6758324,-73.9561677,13,5,18
W 170 St & University Ave,40.84207,-73.926075,1,19,20
Menahan St & Wyckoff Ave,40.70113,-73.91422,11,9,20
E 114 St & 1 Ave,40.7945663,-73.9362541,14,9,23
Ave D & E 3 St,40.72082834,-73.97793172,27,21,48
Edgecombe Ave & W 167 St,40.838191,-73.936085,0,18,18
W 100 St & Broadway,40.7973721,-73.97041192,4,30,34
Caton Ave & E 10 St,40.648481,-73.97058,24,4,28
Morningside Ave & W 123 St,40.81,-73.9551508,19,10,29
Gerard Ave & E 164 St,40.830262,-73.923391,4,11,15
Eastern Pkwy & Brooklyn Ave,40.66939,-73.94514,8,12,20
Riverview Park,40.7443187,-74.0439909,10,6,16
W 42 St & 6 Ave,40.75492,-73.98455,8,36,44
Riverside Dr & W 138 St,40.823168,-73.955857,11,16,27
39 St & Queens Blvd,40.74431,-73.92601,6,15,21
95 St & 35 Ave,40.75301,-73.87266,4,18,22
W 78 St & Broadway,40.78339981,-73.98093133,6,30,36
Coffey St & Conover St,40.677236,-74.015665,12,16,28
Warren St & Smith St,40.685424009970184,-73.99127773940563,21,5,26
E 91 St & Park Ave,40.7835016,-73.955327,24,2,26
59 St & 4 Ave,40.641269,-74.017651,27,1,28
5 Ave & W 126 St,40.80722,-73.9418,16,8,24
W 15 St & 6 Ave,40.738046142482766,-73.99642959237099,7,64,71
Crotona Pkwy & Elsmere Pl,40.84188,-73.8855,9,13,22
Powers St & Olive St,40.71323,-73.93894,10,6,16
E 55 St & 2 Ave,40.75797322,-73.96603308,4,20,24
Morris Ave & E 142 St,40.814469,-73.924963,5,15,20
Case St & 94 St,40.74619,-73.87193,3,17,20
E 2 St & Ave B,40.72217444,-73.98368779,73,8,81
Fulton Ave & E 168 St,40.830471,-73.904556,5,15,20
W 92 St & Broadway,40.7921,-73.9739,1,18,19
36 St & 4 Ave,40.654144,-74.00422,23,3,26
Bloomfield St & 15 St,40.75453,-74.02658,13,0,13
Broadway & W 153 St,40.831327,-73.946665,5,11,16
E 17 St & 2 Ave,40.73431166276575,-73.98372530937195,13,22,35
Forley St & Lamont Ave,40.74463,-73.87386,2,18,20
Market St & Henry St,40.71310702305908,-73.99446353316307,33,3,36
Pacific St & Smith St,40.687880939612775,-73.98939281702042,39,3,42
Pacific St & Classon Ave,40.6791944,-73.9587903,14,3,17
Montague St & Hicks St,40.69522407512035,-73.99598850939152,18,13,31
W 56 St & 10 Ave,40.768254,-73.988639,8,28,36
Grand Concourse & E 199 St,40.87142,-73.88839,14,6,20
Knickerbocker Ave & Halsey St,40.693,-73.90824,8,11,19
Seneca Ave & Irvine St,40.81885,-73.88821,13,4,17
New York Ave & Snyder Ave,40.64868,-73.94635,15,5,20
111 St & 49 Ave,40.74612,-73.85272,16,9,25
Home St & Westchester Ave,40.827629,-73.886659,17,2,19
Andrews Ave S & W 179 St,40.855156,-73.91278,2,17,19
Lott St & Erasmus St,40.64949,-73.95408,8,11,19
Putnam Ave & Throop Ave,40.6851532,-73.94111,10,3,13
21 St & Hoyt Ave S,40.774645,-73.923706,21,10,31
E 176 St & Clinton Ave,40.84311,-73.89149,8,9,17
39 Dr & 52 St,40.74732,-73.91197,1,16,17
Jay St & York St,40.701403172577244,-73.98672670125961,29,4,33
Greenpoint Ave & 47 St,40.7424,-73.91808,3,19,22
Clinton St & Centre St,40.67434,-74.00194698,21,0,21
Bedford Ave & Fenimore St,40.65815,-73.95674,10,9,19
E 179 St & Southern Blvd,40.84467,-73.88507,16,7,23
E 134 St & Walnut Ave,40.800425,-73.911034,12,3,15
Freeman St & Reverend James A Polite Ave,40.830529,-73.894717,13,6,19
Carroll St & Washington Ave,40.6686744,-73.9618148,5,14,19
W 45 St & 8 Ave,40.75929124,-73.98859651,44,15,59
Bergen St & Saratoga Ave,40.67423,-73.91656,6,11,17
Cleveland Pl & Spring St,40.722103786686034,-73.99724900722504,2,27,29
E 180 St & Monterey Ave,40.85025,-73.89301,11,5,16
Sumpter St & Fulton St,40.67923,-73.92588,4,15,19
79 St & Woodside Ave,40.74364,-73.88622,2,16,18
E 15 St & 3 Ave,40.734232,-73.986923,7,64,71
Woodside Ave & 55 St,40.74679,-73.90893,0,15,15
Nostrand Ave & Flushing Ave,40.69928,-73.953259,17,7,24
20 Ave & 31 St,40.78001336610564,-73.90667617321014,5,16,21
Franklin St & Dupont St,40.73564,-73.95866,19,0,19
Myrtle Ave & Lewis Ave,40.69681963,-73.93756926,12,5,17
1 Ave & E 94 St,40.7817212,-73.94594,28,8,36
E 135 St & St Ann's Ave,40.805089,-73.918889,21,0,21
E 35 St & Madison Ave,40.74848023448579,-73.98255586624146,11,36,47
49 St & 25 Ave,40.764496,-73.904632,6,18,24
Strong St & University Ave,40.87119,-73.89918,5,13,18
Carlton Ave & Park Ave,40.69580705,-73.97355569,16,5,21
Clinton St & Tillary St,40.696232971293156,-73.99142056703568,2,22,24
Sheridan Ave & E 172 St,40.840494,-73.911479,9,13,22
19 St & 24 Ave,40.7774552,-73.9225403,15,7,22
Winthrop St & Schenectady Ave,40.6582,-73.9338,11,8,19
Forsyth St & Canal St,40.7158155,-73.99422366,13,8,21
6 Ave & 21 St,40.66016,-73.990974,17,5,22
100 St & 37 Ave,40.75243,-73.86717,6,12,18
Beaver St & Fayette St,40.70099,-73.93921,27,0,27
Malcolm X Blvd & DeKalb Ave,40.6938,-73.93114,8,11,19
Walton Ave & E 183 St,40.858472,-73.90266,9,15,24
Somers St & Rockaway Ave,40.67872,-73.91105,8,12,20
Carroll St & 5 Ave,40.6751622,-73.9814832,13,11,24
Astor Place,40.71928220070702,-74.07126188278198,2,12,14
12 St & Sinatra Dr N,40.750604142368964,-74.02402013540268,25,1,26
Cedar St & Myrtle Ave,40.697842,-73.926241,5,19,24
E 45 St & 3 Ave,40.75255434,-73.97282625,3,30,33
Morris Ave & McClellan St,40.831584,-73.9149,18,1,19
E 161 St & River Ave,40.827883,-73.927111,28,7,35
Park Ave & Marcy Ave,40.697576,-73.948881,9,14,23
81 St & 35 Ave,40.75179,-73.88568,4,17,21
3 Ave & E 189 St,40.85985,-73.89135,27,2,29
27 Ave & 3 St,40.77485,-73.9342,7,8,15
Decatur Ave & Bedford Park Blvd,40.86813,-73.88412,20,0,20
Riverside Dr & W 82 St,40.78720869,-73.98128127,24,41,65
Fulton St & Adams St,40.692418292578466,-73.98949474096298,22,22,44
32 Ave & 81 St,40.75763,-73.88682,7,11,18
Driggs Ave & S 2 St,40.712628,-73.960575,23,7,30
Jerome Ave & W 193 St,40.86659,-73.89794,8,7,15
W 74 St & Columbus Ave,40.7785669,-73.97754961,19,5,24
Central Ave & Himrod St,40.69676,-73.92302,11,10,21
W 17 St & 8 Ave,40.74177603,-74.00149746,42,31,73
Paul Ave & W 205 St,40.87704,-73.88943,13,6,19
Ditmars Blvd & 79 St,40.768728,-73.890745,20,5,25
3 Ave & E 174 St,40.84224,-73.8985,26,6,32
Broadway & 49 St,40.755389,-73.911517,7,16,23
Calyer St & Jewel St,40.72984,-73.94839,27,13,40
Cypress Hills St & Otto Rd,40.70204,-73.89288,18,0,18
61 St & 39 Ave,40.7471,-73.9028,23,6,29
E 179 St & Daly Ave,40.84335,-73.88247,8,10,18
Concourse Village West & E 156 St,40.823162,-73.923267,4,11,15
Grand St,40.71517767732029,-74.03768330812454,4,13,17
Perry St & Bleecker St,40.73535398,-74.00483091,61,9,70
Broadway & Battery Pl,40.70463334,-74.01361706,23,25,48
Waldron St & 108 St,40.73916,-73.8526,18,0,18
Prospect Pl & Underhill Ave,40.6769694,-73.96579,13,3,16
Broadway & Moylan Pl,40.8143256,-73.9590255,28,5,33
Queens Blvd & 56 St,40.74193,-73.90913,8,11,19
1 Ave & E 42 St,40.7487575,-73.970127,32,26,58
Amsterdam Ave & W 189 St,40.85318758861975,-73.92715752124786,4,16,20
Buffalo Ave & E New York Ave,40.66591,-73.92602,13,7,20
E 182 St & Grand Concourse,40.85591,-73.90051,1,22,23
Prospect Ave & E 151 St,40.814232,-73.903927,5,14,19
5 Ave & 67 St,40.635679,-74.020005,18,2,20
34 Ave & 74 St,40.75297,-73.89236,15,9,24
E 2 St & Ave C,40.7208736,-73.98085795,59,16,75
Sands St & Jay St,40.700119,-73.9862,34,7,41
Fulton Ave & E 172 St,40.839229,-73.899047,1,15,16
Christ Hospital,40.734785818,-74.050443636,9,11,20
112 St & Northern Blvd,40.75788,-73.85763,16,4,20
59 St & 5 Ave,40.640125,-74.015726,18,9,27
Irving Ave & Palmetto St,40.698,-73.9127,10,9,19
University Ave & Macombs Rd,40.8496401,-73.9161206,2,21,23
W 76 St & Columbus Ave,40.7801839724239,-73.97728532552719,14,31,45
Devoe St & Lorimer St,40.71335226222875,-73.9491033554077,11,6,17
Lewis Ave & Fulton St,40.67972,-73.93467,11,6,17
E 43 St & 2 Ave,40.75022392,-73.97121414,13,34,47
Cortelyou Rd & E 34 St,40.64454,-73.94486,15,2,17
46 St & Queens Blvd,40.74349759836971,-73.91860529780388,2,26,28
Picnic Point,40.68512559515415,-74.02535319328308,0,39,39
26 Ave & 2 St,40.77684387,-73.93463418,13,5,18
Goulden Ave & W 205 St,40.87812,-73.89192,3,15,18
53 Ave & 94 St,40.73921,-73.86887,7,11,18
Tilden Ave & Nostrand Ave,40.64683,-73.94933,20,0,20
62 St & 43 Ave,40.74261,-73.903,8,10,18
E 7 St & Ave B,40.7251285241158,-73.98131668567657,22,36,58
99 St & 35 Ave,40.75404,-73.86887,4,18,22
2 Ave & E 29 St,40.741723510974715,-73.97809267044067,18,28,46
E 6 St & 2 Ave,40.727378693232225,-73.98840844631195,46,18,64
21 St & 21 Ave,40.782465,-73.914527,12,5,17
Soissons Landing,40.69231660719192,-74.01486575603485,25,0,25
Schermerhorn St & Court St,40.6910363748993,-73.99201065301895,47,11,58
W 89 St & Columbus Ave,40.7882213,-73.97041561,28,19,47
44 Dr & 21 St,40.748036,-73.946705,4,35,39
Little West St & 1 Pl,40.70569254,-74.01677685,29,0,29
E 66 St & Madison Ave,40.76800889305947,-73.96845281124115,2,32,34
108 St & 39 Ave,40.75165,-73.85915,9,12,21
35 St & Broadway,40.760339,-73.9222427,3,11,14
44 Dr & Jackson Ave,40.74718234,-73.9432635,15,17,32
2 Ave & 37 St,40.65624,-74.00933,43,1,44
Front St & Jay St,40.702461,-73.986842,15,5,20
E 10 St & 5 Ave,40.73331967,-73.99510132,0,16,16
51 Ave & Junction Blvd,40.74087,-73.86772,15,0,15
Halsey St & Broadway,40.68565,-73.91564,10,9,19
Southern Blvd & E 175 St,40.839335,-73.886445,9,7,16
Berkeley Pl & 6 Ave,40.6765304,-73.97846879,28,11,39
Linden Blvd & Nostrand Ave,40.65272,-73.94994,10,10,20
Broadway & Roebling St,40.70924826276157,-73.96063148975372,25,2,27
92 St & Astoria Blvd,40.76313,-73.8772,17,0,17
Charlotte St & Boston Rd,40.8358771,-73.8931428,4,12,16
W 18 St & 9 Ave,40.7435337324616,-74.00367558002472,28,7,35
Brook Ave & E 138 St,40.807408,-73.91924,17,1,18
Grand Concourse & E 171 St,40.839549,-73.913004,7,15,22
Ralph Ave & Fulton St,40.67922,-73.92192,21,4,25
Broadway & W 157 St,40.83402740143528,-73.94510813442648,16,9,25
Leonard St & Church St,40.717571,-74.005549,29,20,49
56 St & 2 Ave,40.645705,-74.020292,32,3,35
Bedford Ave & Bergen St,40.676368,-73.952918,18,0,18
Bus Slip & State St,40.701907,-74.013942,64,4,68
Greene Ave & Grandview Ave,40.709697,-73.907856,6,8,14
JC Medical Center,40.71539114317,-74.04969155788422,19,0,19
Church Ave & E 45 St,40.65159,-73.93535,8,15,23
Fulton St & William St,40.70960089363537,-74.00655090808868,5,30,35
Hoboken Terminal - River St & Hudson Pl,40.7360676564825,-74.02912706136703,0,45,45
E 81 St & York Ave,40.7728384,-73.94989233,12,33,45
69 St & 43 Ave,40.74179,-73.89564,4,15,19
W 25 St & 8 Ave,40.74649996333341,-73.99732626293645,17,47,64
Park Circle & East Dr,40.651566,-73.972212,26,0,26
50 St & 7 Ave,40.642501,-74.006055,4,17,21
Degraw St & Hoyt St,40.681990442707026,-73.99079024791718,22,0,22
E Fordham Rd & Webster Ave,40.861748,-73.89105,28,3,31
Ave D & E 10 St,40.72506551015475,-73.97515833377838,10,17,27
36 St & Queens Blvd,40.74408,-73.92901,9,13,22
Flatbush Ave & Lincoln Rd,40.66131,-73.96091,7,3,10
E 174 St & Longfellow Ave,40.836274,-73.884308,16,1,17
Wilson Ave & Moffat St,40.68906,-73.90506,5,24,29
E 156 St & Brook Ave,40.819823,-73.912411,3,14,17
8 Ave & W 33 St,40.751551,-73.993934,64,30,94
Pleasant Ave & E 120 St,40.7974772,-73.9311847,13,3,16
Onderdonk Ave & Gates Ave,40.70413,-73.90737,5,14,19
Prospect Pl & 6 Ave,40.6793307,-73.97519523,13,10,23
University Ave & Brandt Pl,40.848354,-73.918389,7,13,20
Lincoln Ave & E 138 St,40.810893,-73.927311,10,10,20
Edgecombe Ave & W 141 St,40.820681,-73.945144,13,5,18
8 Ave & W 27 St,40.747968,-73.996637,20,7,27
W 20 St & 5 Ave,40.73972989238724,-73.99103969335556,7,46,53
Lenox Ave & W 146 St,40.821111,-73.935971,3,20,23
Prospect Park SW & 10 Ave,40.659945,-73.977504,0,25,25
Boone Ave & E 172 St,40.832649,-73.885272,9,6,15
Ave D & E 12 St,40.72580614,-73.97422494,12,27,39
81 St & 34 Ave,40.75374,-73.88604,11,12,23
Marshall St & 2 St,40.740802,-74.042521,7,9,16
West End Ave & W 60 St,40.77237,-73.99005,23,10,33
46 St & 30 Rd,40.76072,-73.910989,7,11,18
Bayard St & Leonard St,40.71915571696044,-73.94885390996933,37,5,42
31 Ave & 30 St,40.7647,-73.9240312,12,5,17
49 Ave & 27 St,40.74113,-73.942518,14,10,24
14 St Ferry - 14 St & Shipyard Ln,40.752960630464955,-74.02435272932053,28,1,29
43 St & 35 Ave,40.754139,-73.919543,4,21,25
Richards St & Delavan St,40.6794327,-74.00785041,5,10,15
Park Pl & Buffalo Ave,40.67202,-73.92539,8,11,19
E 61 St & Madison Ave,40.764752828526326,-73.97037800510203,0,36,36
E 89 St & 3 Ave,40.7806284,-73.9521667,33,0,33
Grand Concourse & E 181 St,40.85466,-73.9015,10,12,22
56 Dr & 61 St,40.72368,-73.90458,13,3,16
Lexington Ave & E 29 St,40.74311555376486,-73.98215353488922,19,34,53
Ogden Ave & W 165 St,40.834457,-73.928381,6,13,19
Willoughby Ave & Hall St,40.69196035,-73.96536851,22,23,45
Yankee Ferry Terminal,40.68706579875912,-74.01675585121666,25,5,30
Sedgwick Ave & W Burnside Ave,40.854947,-73.916661,5,12,17
Maple St & Flatbush Ave,40.66026,-73.96045,5,12,17
5 St & Market St,40.699997484388504,-73.97440128028393,0,39,39
Southern Blvd & E 180 St,40.84605,-73.88426,5,12,17
65 Ln & Metropolitan Ave,40.7123,-73.89397,21,1,22
Van Sinderen Ave & Atlantic Ave,40.67621,-73.90351,2,18,20
Broadway & W 160 St,40.835775,-73.9434,18,2,20
W 55 St & 6 Ave,40.763189,-73.978434,5,68,73
Popham Ave & W 174 St,40.847746,-73.922079,12,4,16
Church Ave & Nostrand Ave,40.65074,-73.94986,16,8,24
Broadway & W 61 St,40.77003010255044,-73.9819684624672,3,48,51
Henry St & Atlantic Ave,40.69089272,-73.99612349,11,6,17
38 St & Northern Blvd,40.752372,-73.925384,15,6,21
21 St & 31 Dr,40.7659,-73.930819,15,1,16
Washington St,40.7242941,-74.0354826,6,9,15
57 St & 1 Ave,40.646377,-74.023087,17,10,27
Amsterdam Ave & W 136 St,40.819746,-73.951819,12,4,16
Columbia St & Kane St,40.68763155,-74.0016256,18,0,18
Clay Ave & E 173 St,40.843264,-73.904867,1,16,17
Scholes St & Manhattan Ave,40.70870368,-73.9448625,28,8,36
Alexander Ave & E 134 St,40.807466,-73.927107,10,8,18
E 58 St & 1 Ave (NE Corner),40.75892386377695,-73.96226227283478,7,21,28
55 Dr & Maurice Ave,40.7261,-73.90917,14,2,16
Rogers Ave & Snyder Ave,40.64871,-73.95218,20,0,20
6 Ave & Walker St,40.7197920901383,-74.0052238852195,7,29,36
Bushwick Ave & Stagg St,40.709897,-73.94008,4,14,18
Longwood Ave & Southern Blvd,40.816343,-73.896447,22,0,22
Brunswick & 6th,40.72601172964625,-74.05038893222809,2,12,14
E 138 St & Cypress Ave,40.805559,-73.914718,6,13,19
36 St & Hunters Point Ave,40.73781699881193,-73.93024072051048,4,16,20
E 142 St & 3 Ave,40.812735,-73.923697,15,4,19
E 20 St & 2 Ave,40.73587678,-73.98205027,14,66,80
Grand St & Samuel Dickstein Plaza,40.715118719964956,-73.98417055606842,54,20,74
43 Ave & 40 St,40.74562,-73.92402,17,1,18
1 Ave & E 18 St,40.733812191966315,-73.98054420948029,37,13,50
Smith St & 9 St,40.6746957,-73.99785768,19,0,19
Frederick Douglass Blvd & W 117 St,40.805159,-73.954692,26,7,33
18 St & 27 Ave,40.772768286288304,-73.92743647098541,13,10,23
Amsterdam Ave & W 183 St,40.84925,-73.93022,9,5,14
St Marks Ave & Ralph Ave,40.67372,-73.92199,11,3,14
St Nicholas Ave & W 155 St,40.830663,-73.941323,1,16,17
97 St & 23 Ave,40.7683,-73.87331,18,0,18
St Mary's St & Jackson Ave,40.808891,-73.91081,1,14,15
Wards Meadow Comfort Station,40.78294,-73.93077,5,8,13
Eastern Pkwy & St Marks Ave,40.67319,-73.91083,15,4,19
Amsterdam Ave & W 180 St,40.847396,-73.931205,1,19,20
Old Fulton St,40.70277159,-73.99383605,21,11,32
111 St & 37 Ave,40.75397,-73.85748,10,13,23
Flushing Ave & Woodward Ave,40.71246,-73.91873,15,3,18
E 56 St & 3 Ave,40.75934501,-73.96759673,4,70,74
Broadway & W 56 St,40.7652654,-73.98192338,0,106,106
Central Ave & Starr St,40.700003,-73.92834,20,2,22
Columbus Park - Clinton St & 9 St,40.74816121065146,-74.0324530005455,5,21,26
24 Ave & 87 St,40.7654,-73.88256,17,2,19
Seneca Ave & Decatur St,40.69723,-73.89811,3,16,19
Eastern Pkwy & Washington Ave,40.6716493,-73.9631145,0,29,29
Pulaski St & Throop Ave,40.693115,-73.943149,11,0,11
McGuinness Blvd & Eagle St,40.73555,-73.95284,25,13,38
Walton Ave & E 176 St,40.84833,-73.90971,17,3,20
Walton Ave & E 153 St,40.822351,-73.926907,14,4,18
37 Ave & 106 St,40.75397,-73.862,15,3,18
59 St & 59 Rd,40.71790852734058,-73.908454477787,20,0,20
24 Ave & 92 St,40.76589,-73.87789,19,1,20
E 15 St & 5 Ave,40.736592,-73.992949,1,71,72
3 Ave & E 72 St,40.7699426,-73.96060712,2,30,32
E 23 St & FDR Dr,40.736,-73.97605,4,35,39
Melrose St & Broadway,40.697481,-73.935877,6,12,18
Norman St & Wyckoff Ave,40.69517,-73.90311,10,4,14
W 20 St & 11 Ave,40.746745,-74.007756,48,23,71
Schenectady Ave & Prospect Pl,40.67351,-73.93363,7,8,15
Pacific St & Utica Ave,40.6767,-73.93051,5,14,19
7 Ave & 62 St,40.63556,-74.01298,20,8,28
Washington Ave & Park Ave,40.69610226,-73.96751037,41,3,44
Grand Concourse & E 175 St,40.84627592921954,-73.90931278467178,3,14,17
Bailey Ave & W 229 St,40.87449,-73.90467,20,0,20
Dwight St & Van Dyke St,40.67363551341504,-74.01195555925369,21,2,23
University Pl & E 14 St,40.734814,-73.992085,38,12,50
Sherman Ave & E 166 St,40.83130549267296,-73.91744792461395,5,12,17
Park Ave & St Edwards St,40.69608941,-73.97803415,48,5,53
Wakeman Pl & Ridge Blvd,40.639421,-74.026823,12,0,12
St Ann's Ave & Bruckner Blvd,40.803399,-73.919763,8,7,15
Herkimer St & New York Ave,40.67955,-73.94709,11,10,21
46 Ave & Junction Blvd,40.74399,-73.86781,16,2,18
Riverside Blvd & W 67 St,40.777507027547976,-73.98888587951659,55,14,69
Clinton Ave & Flushing Ave,40.69794,-73.96986848,12,6,18
Broadway & W 53 St,40.76344058,-73.98268129,0,84,84
Gleane St & Britton Ave,40.74646,-73.87996,4,16,20
Dock 72 Way & Market St,40.69985,-73.97141,0,22,22
West St & Liberty St,40.711444,-74.014847,33,3,36
E 85 St & York Ave,40.77536905,-73.94803392,6,36,42
38 Ave & 29 St,40.75473,-73.93367,6,11,17
Morris Ave & E 163 St,40.827230499624726,-73.91765579597632,5,11,16
Featherbed Ln & Jerome Ave,40.845505,-73.914311,14,6,20
Howard St & Lafayette St,40.71910537,-73.99973337,18,9,27
Mets Plaza at Citi Field,40.75521,-73.84672,0,37,37
36 St & Ditmars Blvd,40.774306,-73.908335,7,14,21
Jerome Ave & Anderson Ave,40.830179,-73.928747,8,7,15
W 53 St & 10 Ave,40.76669671,-73.99061728,22,5,27
E 182 St & Morris Ave,40.85670801831255,-73.90265285968779,5,12,17
65 Pl & Woodside Ave,40.74334,-73.89903,1,18,19
E 167 St & Bryant Ave,40.826706,-73.888719,6,10,16
Crescent St & 34 Ave,40.76108,-73.930562,15,11,26
E 74 St & 1 Ave,40.7689738,-73.95482273,33,44,77
Centre St & Seneca Ave,40.69969,-73.9022,7,14,21
Somers St & Broadway,40.67945,-73.90474,21,7,28
Central Park W & W 85 St,40.78476,-73.969862,29,1,30
Central Ave & Melrose St,40.70112,-73.93039,14,1,15
E 77 St & 3 Ave,40.77314236,-73.95856158,9,33,42
Stuyvesant Ave & Gates Ave,40.68834,-73.93306,13,6,19
Steinway St & 28 Ave,40.7656251,-73.9136695,8,13,21
South St & Gouverneur Ln,40.70355377,-74.00670227,26,15,41
Rogers Ave & Sterling St,40.6630619,-73.9538746,9,3,12
E 118 St & Madison Ave,40.8014866,-73.9442507,19,3,22
E 88 St & Park Ave,40.781410700190015,-73.95595908164978,33,1,34
Eagle St & Manhattan Ave,40.735217,-73.954926,32,1,33
E 38 St & Church Ave,40.65106,-73.94193,8,14,22
31 Ave & 84 St,40.75947,-73.88431,15,6,21
Pinehurst Ave & W 187 St,40.855331,-73.937878,1,18,19
King St & Varick St,40.72789701409023,-74.00536268949507,21,7,28
W 13 St & 7 Ave,40.73781509,-73.99994661,34,6,40
Bergen St & Kingston Ave,40.6756,-73.9415,5,16,21
Gillmore St & 27 Ave,40.76399,-73.8669,15,1,16
40 Ave & Crescent St,40.753599202005596,-73.93795609474182,3,17,20
Wilson Ave & Troutman St,40.70166,-73.92754,24,1,25
Wyckoff Ave & Jefferson St,40.707165,-73.923711,11,14,25
8 Ave & W 52 St,40.76370739,-73.9851615,15,12,27
W 18 St & 6 Ave,40.73971301,-73.99456405,10,55,65
35 St & 34 Ave,40.7580583,-73.9242751,15,6,21
Rivington St & Chrystie St,40.72110063,-73.9919254,48,12,60
50 Ave & 65 St,40.73707,-73.90077,17,0,17
E 40 St & Park Ave,40.750756,-73.978326,22,99,121
Grand Ave & W Fordham Rd,40.86288,-73.90316,0,20,20
Broadway & Ellwood St,40.862058,-73.929719,13,2,15
Clifton Pl & Bedford Ave,40.688655,-73.955156,20,3,23
64 St & 3 Ave,40.639978,-74.02324,25,6,31
Adam Clayton Powell Blvd & W 115 St,40.802535,-73.9532423,16,2,18
Hoe Ave & Jennings St,40.832171,-73.889686,2,16,18
61 St & 60 Ln,40.70055,-73.8943,7,8,15
Clinton St & Grand St,40.71559509,-73.9870295,40,17,57
Brooklyn Ave & Beverley Rd,40.64575,-73.94331,8,9,17
4 Ave & Shore Road Dr,40.637033,-74.022141,14,3,17
Forest Ave & Summerfield St,40.69922,-73.89795,7,16,23
Windsor Pl & Howard Pl,40.659490558938955,-73.98013919591904,2,5,7
92 St & 37 Ave,40.75085,-73.87509,4,14,18
Jackson Ave & 46 Rd,40.74524768,-73.94733276,3,23,26
Hancock St & Malcolm X Blvd,40.68487,-73.9293,12,3,15
York St & Marin Blvd,40.716615000830494,-74.0424120426178,12,6,18
Marcy Ave & Lynch St,40.702753,-73.953168,17,4,21
Margaret Corbin Plz & Ft Washington Ave,40.859166,-73.933872,1,21,22
City Hall,40.7177325,-74.043845,11,6,17
Hart St & Wyckoff Ave,40.704876,-73.919911,6,16,22
Franklin Ave & Quincy St,40.68636,-73.95678,12,7,19
Wales Ave & E 147 St,40.811314,-73.907729,2,15,17
Lefferts Pl & Franklin Ave,40.680342423,-73.9557689392,12,10,22
Southern Blvd & E 172 St,40.834124,-73.88955,8,8,16
Kingston Ave & E New York Ave,40.66219,-73.94293,18,3,21
E 24 St & Park Ave S,40.74096374,-73.98602213,4,73,77
Gold St & Frankfort St,40.71069995,-74.00354147,11,28,39
Orchard St & Grand St,40.717318403855785,-73.99067759513855,29,7,36
Butler St & Court St,40.6849894,-73.99440329,24,4,28
Newtown Ave & 23 St,40.7713615,-73.9246145,17,10,27
Park Ave & Marcus Garvey Blvd,40.698617,-73.941342,5,17,22
23 Ave & 83 St,40.76646,-73.88674,18,1,19
W 22 St & 10 Ave,40.74691959,-74.00451887,7,63,70
E 184 St & 3 Ave,40.85472,-73.89022,17,1,18
Warren St & W Broadway,40.71473993,-74.00910627,12,55,67
Central Park W & W 72 St,40.77579376683666,-73.9762057363987,14,35,49
Grand Concourse & E 203 St,40.87382,-73.88661,9,15,24
49 St & 31 Ave,40.758057,-73.909831,12,3,15
N 9 St & Wythe Ave,40.72054,-73.959,3,45,48
Church St & Worth St,40.71688538495366,-74.00650128722191,31,11,42
Columbus Ave & W 95 St,40.7919557,-73.968087,19,9,28
Lexington Ave & Stuyvesant Ave,40.68973,-73.93353,12,0,12
E 16 St & 5 Ave,40.73726186,-73.99238967,48,13,61
Baldwin at Montgomery,40.7236589,-74.0641943,13,1,14
35 Ave & 37 St,40.7557327,-73.9236611,10,19,29
E 20 St & FDR Dr,40.733208626522426,-73.9756813647,48,24,72
Loring Pl North & W 183 St,40.8604244,-73.9093359997,9,9,18
8 Ave & W 38 St,40.75461,-73.99177,26,38,64
Dawson St & Intervale Ave,40.819999,-73.897263,14,0,14
Harborside,40.7192517,-74.034234,13,16,29
Ave C & E 16 St,40.72984830346529,-73.97455215454102,23,23,46
Thomas S. Boyland St & Marion St,40.6814658848122,-73.91415685415268,10,4,14
10 St & 5 Ave,40.6686273,-73.98700053,17,2,19
Kent St & McGuinness Blvd,40.73124,-73.95161,14,3,17
St Johns Pl & Howard Ave,40.66992,-73.92002,11,10,21
Mount Eden Pkwy & Eastburn Ave,40.842675,-73.908544,11,8,19
31 Ave & Crescent St,40.7658346,-73.9265474,15,4,19
W 20 St & 10 Ave,40.745686,-74.005141,44,0,44
E 11 St & 3 Ave,40.73127,-73.98849,63,14,77
Ave D & E 8 St,40.72368361,-73.97574813,20,7,27
Frederick Douglass Blvd & W 129 St,40.8125511,-73.9492286,23,1,24
Brooklyn Ave & Lefferts Ave,40.662564,-73.945565,19,0,19
Clarkson Ave & Nostrand Ave,40.6555,-73.94975,18,4,22
Academy St & Nagle Ave,40.862562,-73.922661,7,11,18
Henry St & Degraw St,40.6847514,-73.99917254,22,0,22
Schenectady Ave & Cortelyou Rd,40.64535,-73.93268,19,0,19
6 Ave & W 45 St,40.756951,-73.982631,11,52,63
20 Ave & 38 St,40.777112,-73.902382,21,4,25
W 204 St & Vermilyea Ave,40.866141,-73.922648,10,10,20
Marcy Ave & Rutledge St,40.703681,-73.95427,2,17,19
Stratford Rd & Beverley Rd,40.64378,-73.96867,16,0,16
Broadway & Kosciuszko St,40.69329,-73.92852,4,25,29
W 34 St & 11 Ave,40.75594159,-74.0021163,6,70,76
51 Ave & Alstyne Ave,40.74311,-73.85715,17,3,20
57 St & Grand Ave,40.71921,-73.9124,3,16,19
Grand Concourse & E 167 St,40.834263,-73.917641,3,21,24
E 16 St & Irving Pl,40.735367055605394,-73.98797392845154,24,49,73
Marcy Ave & Hart St,40.693022,-73.94868,13,0,13
McKibbin St & Manhattan Ave,40.70510918,-73.94407279,23,0,23
George St & Wilson Ave,40.702997,-73.92997,14,2,16
W 107 St & Columbus Ave,40.7997568,-73.9621128676,10,2,12
W 52 St & 5 Ave,40.75992262,-73.97648516,0,57,57
Madison Ave & E 82 St,40.7781314,-73.96069399,8,26,34
W 230 St & Marble Hill Ave,40.87807,-73.90796,17,6,23
Peck Slip & South St,40.7075188830923,-74.00108054280281,33,5,38
Pier 61 at Chelsea Piers,40.746872,-74.00821,16,17,33
River Ave & McClellan St,40.83406,-73.92243,14,5,19
William St & Pine St,40.70717936,-74.00887308,9,44,53
3 Ave & Wakeman Pl,40.638246,-74.024714,17,1,18
Lafayette Ave & Hunts Point Ave,40.816567,-73.888161,2,14,16
Manhattan Ave & Devoe St,40.713532,-73.9459867,17,6,23
Grand Concourse & E 166 St,40.83196,-73.91956,0,22,22
48 Ave & 5 St,40.744363287066875,-73.9558732509613,76,0,76
Webster Ave & E 166 St,40.828975,-73.911259,13,3,16
96 St & Northern Blvd,40.75712,-73.8722,9,9,18
W 106 St & Amsterdam Ave,40.8008363,-73.9664492472,14,13,27
Newport PATH,40.7272235,-74.0337589,4,10,14
E Mosholu Pkwy & E 204 St,40.8740704,-73.8833650931,5,12,17
E 16 St & Cortelyou Rd,40.64173,-73.96364,22,0,22
39 Ave & 56 St,40.74838,-73.90699,13,4,17
37 St & 24 Ave,40.7701477,-73.9120938,10,7,17
E 47 St & 1 Ave,40.75206862,-73.96784384,21,44,65
Sullivan St & Washington Sq,40.73047747,-73.99906065,21,31,52
57 St & 4 Ave,40.642622,-74.016866,8,6,14
Bialystoker Pl & Delancey St,40.71622644,-73.98261206,25,4,29
Henry St & Grand St,40.714211,-73.981095,34,0,34
Pioneer St & Van Brunt St,40.679043,-74.011169,16,19,35
Waverly Ave & Lafayette Ave,40.688231,-73.966804,9,8,17
Murray St & Greenwich St,40.714851505262516,-74.01122331619263,23,20,43
E 60 St & York Ave,40.759107,-73.959223,4,27,31
Dahill Rd & 12 Ave,40.646037,-73.980963,3,16,19
Waterbury St & Stagg St,40.71019,-73.93734,14,5,19
Greenwich St & Rector St,40.70806582380646,-74.0135595202446,57,1,58
E 58 St & Madison Ave,40.76302594280519,-73.97209525108337,0,63,63
24 St & 5 Ave,40.659555,-73.995068,12,1,13
Broadway & W 29 St,40.7462009,-73.98855723,22,67,89
E 171 St & Webster Ave,40.838379,-73.905838,13,1,14
E 48 St & 5 Ave,40.75724567911726,-73.97805914282799,0,60,60
Fulton St & Irving Pl,40.68186,-73.959432,23,6,29
3 St & Hoyt St,40.6777287,-73.99364123,47,1,48
39 Ave & 54 St,40.74891,-73.90899,6,12,18
Kosciuszko St & Tompkins Ave,40.69128258,-73.9452416,16,0,16
60 Pl & Linden St,40.70886,-73.90182,13,7,20
Grand Ave & 55 St,40.71888,-73.91427,10,9,19
E 7 St & Ave C,40.72412944090093,-73.97901266813278,29,1,30
Fort Washington Ave & W 183 St,40.852252,-73.937854,1,24,25
Wyckoff Ave & Stanhope St,40.703545,-73.917775,3,19,22
E 89 St & York Ave,40.7779453,-73.946041,28,1,29
Clinton St & Cherry St,40.711471394469264,-73.98672603070736,31,1,32
E 53 St & Madison Ave,40.7597108,-73.97402311,0,6,6
48 Ave & 41 St,40.73985995699164,-73.92400324344635,6,12,18
Spring St & Hudson St,40.72583996792375,-74.0076532959938,43,8,51
3 Ave & Carroll St,40.677027,-73.9865,4,22,26
Broadway & E 21 St,40.739888408589955,-73.98958593606949,2,42,44
W 56 St & 6 Ave,40.76340613,-73.97722479,2,44,46
Crotona Ave & Crotona Park N,40.84234,-73.89409,3,16,19
6 Ave & 55 St,40.640831,-74.010996,4,14,18
River Ter & Warren St,40.71759894980997,-74.01587963104248,68,1,69
Forsyth St & Grand St,40.71779817737835,-73.99316132068634,45,16,61
W 218 St & Indian Rd,40.873054589370895,-73.91837194561958,7,13,20
Bedford Ave & S 9 St,40.70853074,-73.96408963,17,2,19
78 St & Northern Blvd,40.75499,-73.88905,24,16,40
Prospect Pl & Nostrand Ave,40.67428,-73.9503,8,11,19
51 Ave & Van Loon St,40.73832,-73.87913,20,3,23
Westchester Ave & Jackson Ave,40.816124,-73.908116,15,7,22
E 82 St & East End Ave,40.7724607,-73.9468208,12,20,32
E 141 St & St Ann's Ave,40.808633,-73.916124,13,1,14
Broadway & 51 St,40.754164,-73.908906,11,13,24
Chauncey St & Malcolm X Blvd,40.68044,-73.92842,1,21,22
E 169 St & Fox St,40.827184,-73.893721,2,16,18
Knickerbocker Ave & Hancock St,40.69385,-73.90974,8,11,19
W 35 St & 9 Ave,40.75414519263519,-73.9960889518261,8,22,30
Davidson Ave & W Burnside Ave,40.853646,-73.908731,25,7,32
Marcy Ave & Lafayette Ave,40.6900815,-73.947915,18,0,18
Wyckoff Ave & Cooper Ave,40.69338,-73.90061,12,6,18
Woodhaven Blvd & Hoffman Dr,40.73303,-73.871,19,5,24
11 St & Washington St,40.74998490907138,-74.02715027332306,22,0,22
W 13 St & 5 Ave,40.735445,-73.99431,9,30,39
E 21 St & Church Ave,40.65007,-73.96001,21,2,23
Columbus Pl & Atlantic Ave,40.67717,-73.92285,4,13,17
Warren St & Roosevelt Ave,40.74919,-73.87054,9,10,19
Madison St & Malcolm X Blvd,40.68713,-73.93008,17,8,25
W 100 St & Manhattan Ave,40.795,-73.9645,20,11,31
W 46 St & 11 Ave,40.76341379,-73.99667444,9,9,18
Fairmount Pl & Prospect Ave,40.843099,-73.889927,5,10,15
20 Ave & 42 St,40.775415,-73.900063,17,2,19
Schenectady Ave & Maple St,40.66178,-73.93445,17,1,18
Fresh Pond Rd & Flushing Ave,40.72155,-73.90295,16,1,17
32 Ave & 84 St,40.75793,-73.88401,3,15,18
60 Ave & Junction Blvd,40.73466,-73.86501,21,2,23
7 St & Monroe St,40.74641264837719,-74.03797701001167,9,13,22
Lenox Ave & W 126 St,40.808442,-73.9452087,11,15,26
Macombs Rd & W 175 St,40.848177,-73.916082,0,18,18
Bergen St & Buffalo Ave,40.6747,-73.92512,3,17,20
3 Ave & E 172 St,40.839586,-73.900277,9,8,17
Greene Ave & Myrtle Ave,40.698568,-73.918877,17,7,24
64 St & 53 Dr,40.72897,-73.90115,18,0,18
Sharon St & Olive St,40.715341620424475,-73.93865078687668,10,12,22
Cedar St & Evergreen Ave,40.69671,-73.92807,7,17,24
Bainbridge Ave & Bedford Park Blvd,40.87002,-73.88565,12,5,17
33 St & 47 Ave,40.74283,-73.9321,14,10,24
Southwest Park - Jackson St & Observer Hwy,40.73755127245804,-74.04166370630264,12,8,20
Henry St & Remsen St,40.69400964865994,-73.99465128779411,5,12,17
Bedford Ave & Beverley Rd,40.64491,-73.95487,24,0,24
E 170 St & Sheridan Ave,40.838315,-73.912604,4,25,29
Degraw St & Smith St,40.6829151,-73.99318208,25,2,27
Front St & Washington St,40.70255088,-73.98940236,45,10,55
37 Ave & 113 St,40.75475,-73.8549,30,0,30
Ocean Ave & Crooke Ave,40.65326,-73.96172,25,0,25
W 116 St & Broadway,40.8082,-73.9641,14,17,31
W Tremont Ave & Matthewson Rd,40.853827,-73.920765,13,3,16
E 128 St & Madison Ave,40.80756,-73.939182,14,8,22
Valentine Ave & E 181 St,40.854123869116,-73.89932222664356,5,14,19
Macon St & Nostrand Ave,40.6809833854,-73.9500479759,8,9,17
5 Ave & E 135 St,40.812191,-73.937838,14,7,21
Butler St & 27 Ave,40.76521,-73.86483,16,1,17
Macombs Rd & Featherbed Ln,40.84552,-73.91722,12,4,16
30 Ave & 41 St,40.763422,-73.914142,3,18,21
Tompkins Ave & Hopkins St,40.69957608,-73.94708417,7,7,14
Menahan St & Onderdonk Ave,40.70553,-73.9096,11,7,18
Sterling St & Nostrand Ave,40.66318,-73.95076,9,9,18
7 Ave & 17 St,40.660937794931684,-73.98680448532104,14,2,16
W 50 St & 9 Ave,40.763604677958625,-73.98917958140373,18,4,22
E Houston St & Columbia St,40.71978635452822,-73.97871628403664,43,4,47
Fulton St & Utica Ave,40.6794268,-73.9298911,0,19,19
Grand St & Elizabeth St,40.718822,-73.99596,33,5,38
New York Ave & St Marks Ave,40.67514,-73.94716,15,5,20
Vernon Blvd & 50 Ave,40.74232744,-73.95411749,27,15,42
Bradley Ave & Greenpoint Ave,40.73565914819229,-73.93478840589523,18,3,21
E 25 St & 2 Ave,40.73912601,-73.97973776,16,58,74
W 36 St & 9 Ave,40.75462324029105,-73.99516761302948,0,0,0
36 Ave & 10 St,40.7614376,-73.9411265,11,7,18
E 49 St & Church Ave,40.65182,-73.93135,24,0,24
Graham Ave & Conselyea St,40.715143,-73.944507,6,21,27
Lispenard St & Broadway,40.71939226,-74.00247214,65,10,75
Paul Ave & Mosholu Pkwy,40.8802945,-73.8860653648,19,0,19
Center Blvd & 48 Ave,40.745038,-73.957539,23,4,27
Gerard Ave & McClellan St,40.833909,-73.92112,10,18,28
Metropolitan Ave & Flushing Ave,40.71334,-73.91572,18,0,18
Lenox Ave & W 140 St,40.817245,-73.938787,5,17,22
W 147 St & Adam Clayton Powell Blvd,40.82281,-73.937413,9,12,21
31 St & Broadway,40.76211,-73.92523,10,20,30
E 33 St & 1 Ave,40.74322681432173,-73.97449783980846,21,59,80
Marble Hill Ave & W 225 St,40.87471,-73.91099,18,0,18
Madison St & Cypress Ave,40.70068,-73.90742,4,11,15
Church Ave & McDonald Ave,40.642809,-73.979239,4,24,28
23 St & 3 Ave,40.662611,-73.998623,23,0,23
St Nicholas Terrace & Convent Ave,40.821294,-73.947868,1,17,18
Eastern Pkwy & Troy Ave,40.66929,-73.93679,11,10,21
Queens Plaza North & Crescent St,40.75110165,-73.94073717,8,36,44
Lenox Rd & E 43 St,40.65496,-73.93765,9,10,19
108 St & 52 Ave,40.74310053056842,-73.85466891367044,8,27,35
Menahan St & Central Ave,40.69543,-73.9196,9,13,22
Columbus Drive,40.71835519823214,-74.03891444206238,11,3,14
Church Ave & E 42 St,40.65127,-73.93818,7,18,25
8 St & Washington St,40.745983882915624,-74.02819901704788,16,2,18
Broadway & W 131 St,40.817555,-73.957163,13,7,20
62 St & 4 Ave,40.639859,-74.019776,14,4,18
Cumberland St & Lafayette Ave,40.68753406,-73.97265183,5,24,29
Ditmars Blvd & 94 St,40.7702,-73.87587,9,6,15
1 Ave & E 16 St,40.73221853,-73.98165557,6,48,54
Lexington Ave & Patchen Ave,40.6904,-73.9277,11,0,11
61 St & Laurel Hill Blvd,40.7388,-73.90338,9,8,17
Rogers Ave & Lenox Rd,40.65378,-73.95273,11,11,22
4 Ave & 26 St,40.660079,-73.998633,20,0,20
Willow Ave & E 133 St,40.800933,-73.913863,18,1,19
Classon Ave & St Marks Ave,40.676513,-73.959431,22,3,25
Bradhurst Ave & W 148 St,40.825125,-73.941616,12,5,17
Broadway & W 48 St,40.76017739537783,-73.98486793041229,27,66,93
9 Ave & W 33 St,40.752568,-73.996765,29,62,91
Cortelyou Rd & Stratford Rd,40.63966,-73.96807,19,0,19
3 Ave & E 163 St,40.823872,-73.908699,19,6,25
Pike St & Monroe St,40.71173107,-73.99193043,27,0,27
40 Ave & 9 St,40.75742,-73.945133,10,7,17
44 St & 3 Ave,40.651173,-74.011405,23,0,23
53 St & 5 Ave,40.643371,-74.011884,1,28,29
Parade Pl & Crooke Ave,40.651847,-73.965248,17,7,24
Lafayette St & E 8 St,40.73020660529954,-73.99102628231049,23,70,93
52 St & 6 Ave,40.642703,-74.009441,2,14,16
Church Ave & Story St,40.642031,-73.981073,8,15,23
Westchester Ave & E 156 St,40.817802,-73.905203,13,5,18
34 St & 38 Ave,40.752443,-73.929737,6,17,23
65 St & 2 Ave,40.640493,-74.02564,16,3,19
Crown St & Rogers Ave,40.66639,-73.95346,8,10,18
Westchester Ave & Southern Blvd,40.824956,-73.891677,11,4,15
Dey St,40.737711,-74.066921,9,9,18
W 4 St & 7 Ave S,40.73401143,-74.00293877,40,12,52
35 St & 21 Ave,40.776745,-73.906558,6,14,20
63 St & 5 Ave,40.63766,-74.01782,22,1,23
42 Pl & Northern Blvd,40.753091,-73.920603,18,7,25
E 7 St & Ave A,40.72621788,-73.98379855,29,5,34
1 Pl & Clinton St,40.6809591,-73.99905709,32,0,32
W 30 St & 10 Ave,40.752694,-74.002353,34,9,43
W 22 St & 8 Ave,40.74475148,-73.99915362,25,29,54
Grand St & Havemeyer St,40.71286844,-73.95698119,16,9,25
Pershing Field,40.742677141,-74.051788633,2,15,17
Grand Concourse & E 164 St,40.829608,-73.921461,2,18,20
Fresh Pond Rd & 69 Ave,40.70311,-73.89547,4,22,26
Putnam Ave & Wyckoff Ave,40.69811,-73.90904,11,10,21
Frederick Douglass Blvd & W 145 St,40.823061,-73.941928,19,6,25
Bergen Ave & Sip Ave,40.73100888698729,-74.06443700194359,0,30,30
Washington Ave & Empire Blvd,40.66314,-73.9605695,13,14,27
3 St & 3 Ave,40.6750705,-73.98775226,74,3,77
Vyse Ave & E 181 St,40.84463,-73.87988,8,12,20
W 59 St & 10 Ave,40.770513,-73.988038,13,104,117
Broadway & W 165 St,40.839137,-73.941409,0,22,22
Broadway & W 36 St,40.75097711,-73.98765428,9,68,77
Park Ave & E 42 St,40.751873,-73.977706,4,74,78
Cortelyou Rd & Argyle Rd,40.64034,-73.96603,21,0,21
5 Corners Library,40.734961020009514,-74.0595030784607,3,14,17
W 27 St & 7 Ave,40.74665,-73.99392,11,54,65
60 Pl & 67 Ave,40.70497,-73.89965,1,14,15
21 Ave & Shore Blvd,40.783956,-73.916894,13,4,17
Nagle Ave & Ellwood St,40.86012,-73.928489,15,4,19
Washington Ave & Park Pl,40.675832,-73.963308,20,13,33
Ocean Pkwy & Church Ave,40.644718957635746,-73.97451460361481,13,10,23
Greenpoint Ave & West St,40.729803,-73.959099,12,20,32
St Nicholas Ave & Manhattan Ave,40.809725,-73.953149,18,7,25
Newark Ave,40.72152515,-74.046304543,18,0,18
Corona Ave & 102 St,40.74419,-73.8619,12,8,20
38 St & 30 Ave,40.764174520197685,-73.91583994030952,3,20,23
MacDougal St & Rockaway Ave,40.68018,-73.91136,7,11,18
35 St & 30 Ave,40.76547569244953,-73.91811579465866,13,12,25
Herkimer St & Eastern Pkwy,40.67738,-73.90829,4,12,16
Macon St & Patchen Ave,40.68374,-73.9261,14,2,16
W 25 St & 9 Ave,40.747832605837715,-74.0005722643582,24,35,59
Riverside Dr & W 148 St,40.829114,-73.950426,3,17,20
21 St & 36 Ave,40.7601853,-73.9362726,7,12,19
Tiebout Ave & E Fordham Rd,40.861915,-73.894831,5,19,24
65 St & Broadway,40.749372273899596,-73.89738768339157,6,12,18
W 225 St & Exterior St,40.873265,-73.906646,15,0,15
W 211 St & 10 Ave,40.86709406268147,-73.9172950387001,14,4,18
Willow Ave & 12 St,40.7518674823282,-74.03037697076797,10,3,13
48 St & 5 Ave,40.646351,-74.009271,13,12,25
3 Ave & E 62 St,40.76313,-73.96527,1,48,49
Sherman Ave & Thayer St,40.863124,-73.926994,20,0,20
Suydam St & Broadway,40.69544,-73.93223,12,19,31
Spruce St & Nassau St,40.71146364,-74.00552427,4,28,32
47 Ave & 48 St,40.74086,-73.91708,0,19,19
52 St & 1 Ave,40.649292,-74.020105,18,2,20
Fulton St & Saratoga Ave,40.67853,-73.91642,12,6,18
Lorimer St & Calyer St,40.72795,-73.95414,9,11,20
62 St & Northern Blvd,40.754176,-73.900318,20,5,25
Graham Ave & Grand St,40.711863,-73.944024,15,10,25
21 St & 38 Ave,40.7576314,-73.9391224,2,17,19
West St & Chambers St,40.71754834,-74.01322069,107,4,111
48 St & Skillman Ave,40.74622874694195,-73.91616314649582,3,19,22
69 St & 38 Ave,40.74694504524519,-73.89650255441666,5,18,23
Grand Ave & Remsen Pl,40.72353,-73.89967,18,1,19
Amsterdam Ave & W 131 St,40.816355,-73.954295,6,12,18
Ash St & Manhattan Ave,40.738095,-73.954867,29,1,30
Amsterdam Ave & W 119 St,40.8086249,-73.9596214,3,22,25
India St & Manhattan Ave,40.73232194,-73.9550858,42,5,47
E 76 St & Park Ave,40.773763,-73.96222088,4,18,22
2 Ave & E 122 St,40.8006721,-73.9349,9,9,18
Columbus Ave & W 103 St,40.7969347,-73.9643412291,4,30,34
Judge St & Britton Ave,40.74454,-73.88112,9,13,22
Richardson St & N Henry St,40.71907891179564,-73.94223690032959,17,7,24
E 44 St & 2 Ave,40.75118387463277,-73.97138714790344,7,31,38
Walton Ave & E 168 St,40.83649,-73.918316,4,11,15
31 Ave & 34 St,40.763154,-73.920827,4,16,20
Irving Ave & DeKalb Ave,40.7027,-73.92095,18,7,25
E 65 St & 2 Ave,40.76471851944339,-73.96222069859505,2,43,45
23 Ave & 31 St,40.77423301703027,-73.91274864321404,3,22,25
28 Ave & 44 St,40.76408932350688,-73.91065120697021,10,7,17
1 Ave & E 62 St,40.7612274,-73.96094022,10,31,41
42 St & 1 Ave,40.654798,-74.014372,16,1,17
Boston Rd & West Farms Rd,40.83998,-73.8806,20,2,22
Leonard Gordon Park,40.74590996631558,-74.0572714805603,2,12,14
Humboldt St & Varet St,40.7031724,-73.940636,35,4,39
5 Ave & E 103 St,40.7922553,-73.95249933,18,12,30
White St & Moore St,40.704508,-73.9351,16,4,20
21 Ave & 80 St,40.770888,-73.889914,17,2,19
Johnson St & Gold St,40.69474881,-73.98362464,14,27,41
24 Ave & 29 St,40.7729,-73.916142,17,25,42
Myrtle Ave & Fleet Pl,40.693534,-73.981909,12,34,46
Amsterdam Ave & W 167 St,40.839443,-73.937044,4,11,15
Morgan Ave & Maspeth Ave,40.716657,-73.93637,16,9,25
Kingston Ave & Carroll St,40.66688,-73.9425,4,16,20
W 110 St & Amsterdam Ave,40.802692,-73.96295,13,28,41
Morris Ave & E 171 St,40.83899,-73.9109,12,8,20
71 St & 32 Ave,40.75675,-73.89595,17,1,18
41 St & 3 Ave,40.652512,-74.008906,19,0,19
W 146 St & Broadway,40.826969,-73.949738,1,27,28
West End Ave & W 107 St,40.8021174,-73.9681805305,0,26,26
7 Ave & W 55 St,40.764126,-73.980973,4,60,64
Borden Ave & Review Ave,40.73866345465306,-73.94093804061413,9,9,18
W 20 St & 7 Ave,40.74238787,-73.99726235,7,31,38
E 171 St & 3 Ave,40.837119,-73.902185,12,8,20
E 51 St & Linden Blvd,40.65399,-73.92967,16,3,19
Graham Ave & Herbert St,40.71929301,-73.94500379,21,5,26
New York Ave & Hawthorne St,40.65794,-73.94735,12,7,19
65 St & Otto Rd,40.70389,-73.89116,9,11,20
Union St,40.7182113,-74.0836394,18,0,18
21 St & 4 Ave,40.662584,-73.995554,21,0,21
W 140 St & Riverside Dr,40.824013,-73.954743,2,21,23
Greenpoint Ave & Monitor St,40.73224,-73.94383,12,7,19
Prospect Ave & Jennings St,40.831762,-73.896853,2,18,20
Broadway & Hancock St,40.68663,-73.9168,10,24,34
Mama Johnson Field - 4 St & Jackson St,40.74313993965626,-74.04004096984863,12,8,20
8 Ave & W 16 St,40.740983,-74.001702,14,22,36
Mt Morris Park W & W 120 St,40.804038,-73.945925,21,3,24
Jerome Ave & W 177 St,40.850121,-73.910765,19,6,25
River St & 1 St,40.73721535335381,-74.02886540972803,2,19,21
W 104 St & Amsterdam Ave,40.799041392882984,-73.96649479866028,2,40,42
Longfellow Ave & E 165 St,40.825322,-73.887729,13,4,17
Hudson Blvd W & W 36 St,40.75676475086503,-73.99971440439913,7,39,46
Corona Ave & 98 St,40.74448,-73.86516,12,6,18
Bailey Ave & W 238 St,40.88417,-73.89793,13,2,15
Clarkson Ave & E 40 St,40.65592,-73.94068,25,4,29
Clermont Ave & Lafayette Ave,40.68764484,-73.96968902,20,30,50
30 St & 4 Ave,40.657743,-74.001141,16,1,17
W Mosholu Pkwy S & Sedgwick Ave,40.88226,-73.88702,7,29,36
W 218 St & Broadway,40.87139,-73.914318,14,11,25
Amsterdam Ave & W 66 St,40.7746671,-73.98470567,3,15,18
E 2 St & 2 Ave,40.72502876,-73.99069656,73,7,80
Gramercy Park N & Gramercy Park E,40.73795,-73.98509,11,31,42
Bergen St & Flatbush Ave,40.680944723477296,-73.97567331790923,8,20,28
36 Ave & 31 St,40.75651272984955,-73.92957486212252,8,16,24
Albemarle Rd & E 21 St,40.64741,-73.95933,16,2,18
Water St & Gouverneur Ln,40.70469667894968,-74.00803416967392,23,10,33
Park Pl & Utica Ave,40.67242,-73.93094,10,7,17
Willis Ave & E 143 St,40.812299,-73.92037,6,15,21
Meserole Ave & Manhattan Ave,40.72708584,-73.95299117,21,6,27
2 St & Park Ave,40.73915272763701,-74.0330819785595,2,13,15
Featherbed Ln & Nelson Ave,40.846011,-73.919637,1,19,20
E 5 St & Cooper Sq,40.72769,-73.990993,27,21,48
E 84 St & Park Ave,40.77862688,-73.95772073,21,18,39
67 Ave & Fresh Pond Rd,40.70575,-73.89676,5,23,28
Valentine Ave & E 183 St,40.856987,-73.898237,5,16,21
E 123 St & Lexington Ave,40.8029263,-73.9379,21,5,26
71 Ave & Myrtle Ave,40.70067,-73.89907,2,24,26
Crescent St & Broadway,40.7633589,-73.9286471,14,3,17
Anthony Ave & E 175 St,40.846465,-73.903869,3,14,17
53 St & Flushing Ave,40.71435,-73.91405,17,2,19
Bedford Ave & Nassau Ave,40.72311651,-73.95212324,26,20,46
E 33 St & 5 Ave,40.74765947,-73.98490707,0,0,0
62 St & 34 Ave,40.75201,-73.89986,15,4,19
Riverside Dr & W 72 St,40.78057799010334,-73.98562431335449,30,0,30
E 43 St & Madison Ave,40.75354681867074,-73.97896572947502,21,34,55
Hunts Point Ave & Bryant Ave,40.813991,-73.8855,9,10,19
Bank St & Washington St,40.7361967,-74.00859207,28,0,28
104 St & 32 Ave,40.75951,-73.86491,8,11,19
Sterling Pl & Classon Ave,40.6739411,-73.96026,7,19,26
Norman Ave & Leonard St,40.725819,-73.950815,13,14,27
Madison St & Montgomery St,40.713126,-73.984844,9,7,16
43 St & 50 Ave,40.73787237950538,-73.92264068126678,9,7,16
E 138 St & Park Ave,40.81263616769319,-73.92924964427948,12,9,21
Lafayette Ave & St James Pl,40.68851534,-73.9647628,4,29,33
Crotona Ave & E Fordham Rd,40.8579,-73.88147,6,16,22
Arthur Ave & E Tremont Ave,40.84616,-73.89322,5,12,17
4 Ave & E 12 St,40.732647,-73.99011,27,7,34
Van Cortlandt Park S & Dickinson Ave,40.88435,-73.88781,9,15,24
Pulaski St & Marcus Garvey Blvd,40.6933982,-73.939877,16,3,19
Clarkson Ave & Utica Ave,40.65666,-73.93109,13,5,18
Adam Clayton Powell Blvd & W 126 St,40.809495347779475,-73.94776493310928,25,6,31
86 St & 37 Ave,40.75,-73.88062,5,12,17
43 St & Broadway,40.7577284,-73.9166368,3,20,23
3 St & 7 Ave,40.6703837,-73.97839676,18,4,22
Carroll St & Franklin Ave,40.6679411,-73.9588,1,15,16
Broadway & W 142 St,40.824686,-73.951947,6,16,22
Broadway & Furman Ave,40.68139,-73.90756,10,18,28
3 Ave & E 112 St,40.795508,-73.941606,18,0,18
River Ave & E 151 St,40.822217,-73.928939,22,3,25
72 St & Woodside Ave,40.74288,-73.89283,3,16,19
32 Ave & 75 St,40.75704,-73.8924,16,2,18
9 Ave & W 45 St,40.76019252,-73.9912551,31,0,31
Fairview Ave & Linden St,40.70694,-73.90632,3,14,17
W 36 St & 7 Ave,40.752149,-73.989539,12,22,34
E 53 St & 3 Ave,40.75763227739443,-73.96930575370789,0,36,36
Prospect Ave & Longwood Ave,40.81899,-73.90202,3,24,27
Washington Ave & E 174 St,40.843079,-73.900216,12,6,18
White St & Johnson Ave,40.707174,-73.93581,20,1,21
Vernon Blvd & 47 Rd,40.7449067,-73.9534573,19,10,29
Washington Pl & Broadway,40.72903917,-73.99404649,16,9,25
Isham St & Broadway,40.86788,-73.919685,25,3,28
Amsterdam Ave & W 156 St,40.832081,-73.942386,4,21,25
12 Ave & W 40 St,40.76087502,-74.00277668,8,58,66
Pacific St & Thomas S. Boyland St,40.67568,-73.91396,8,13,21
W Broadway & W Houston St,40.726378,-74.000472,44,4,48
Eames Pl & Claflin Ave,40.8692,-73.90121,1,19,20
Skillman Ave & 54 St,40.745502,-73.909887,0,16,16
Brook Ave & E 157 St,40.820713,-73.911759,6,9,15
34 Ave & Vernon Blvd,40.76535380385866,-73.93986314535141,24,4,28
46 St & 7 Ave,40.644743,-74.003754,4,16,20
45 Rd & 11 St,40.74708586,-73.94977234,3,18,21
Jerome Ave & W Fordham Rd,40.86294,-73.90108,12,9,21
Rugby Rd & Beverley Rd,40.64435,-73.96591,24,0,24
Troy Ave & Park Pl,40.67251,-73.93642,7,9,16
Madison Ave & E 26 St,40.742684734875695,-73.98671329021454,3,66,69
Adam Clayton Powell Blvd & W 118 St,40.804372,-73.951475,21,0,21
University Ave & W Burnside Ave,40.85501,-73.910751,2,21,23
W 31 St & 7 Ave,40.749156,-73.9916,18,59,77
Arthur Ave & E 183 St,40.85307,-73.88953,16,7,23
W 70 St & Amsterdam Ave,40.77748046,-73.98288594,20,14,34
Putnam Ave & Knickerbocker Ave,40.69545,-73.91164,9,18,27
Broadway & W 238 St,40.88524,-73.90077,28,0,28
97 St & 57 Ave,40.73727,-73.86415,12,8,20
Macon St & Howard Ave,40.68452,-73.92011,19,0,19
Parkside Ave & Parade Pl,40.6532,-73.96639,19,0,19
Cortelyou Rd & E 19 St,40.64269,-73.96099,20,1,21
Hughes Ave & Oak Tree Pl,40.85079,-73.88945,14,5,19
Motorgate,40.7639089,-73.9477213,33,0,33
93 St & Northern Blvd,40.7564,-73.87504,10,10,20
Sedgwick Ave & Hillman Ave,40.88224,-73.89136,7,15,22
Prospect Pl & Vanderbilt Ave,40.67767534,-73.96902144,19,7,26
71 St & 37 Ave,40.7488,-73.89451,4,18,22
St Marks Pl & 1 Ave,40.72779126,-73.98564945,53,8,61
Broadway & W 220 St,40.872412,-73.912807,3,15,18
Huron St & Franklin St,40.73266,-73.95826,23,5,28
Lewis Ave & Decatur St,40.6814598,-73.934903,2,12,14
E 3 St & 1 Ave,40.72467721,-73.98783413,31,20,51
Bedford Ave & Montgomery St,40.665816,-73.956934,5,20,25
W 145 St & Amsterdam Ave,40.825244,-73.947257,3,16,19
Park Ave & E 124 St,40.8045555,-73.9396861,10,23,33
Winthrop St & Nostrand Ave,40.65707,-73.95005,19,2,21
E 22 St & 2 Ave,40.73716919369882,-73.98122549057007,6,39,45
Boerum St & Broadway,40.70538077,-73.94976519,5,10,15
1 Ave & E 68 St,40.76500525,-73.95818491,8,48,56
Grand Army Plaza & Plaza St West,40.6729679,-73.97087984,4,33,37
Broadway & W 192 St,40.857994,-73.932173,17,5,22
34 St & 48 Ave,40.740821207823245,-73.93147185444832,7,16,23
Vernon Blvd & 10 St,40.7671863,-73.9373554,31,9,40
E 4 St & Ave B,40.723346832180155,-73.98265913128853,34,0,34
E 14 St & 1 Ave,40.73139303364151,-73.98286700248718,12,11,23
Pacific St & Sackman St,40.67522,-73.9061,12,7,19
31 Ave & 14 St,40.7682,-73.9322662,10,6,16
Monroe St & Patchen Ave,40.68814,-73.92693,10,7,17
Ditmars Blvd & 19 St,40.78145,-73.9183302,20,4,24
Edgecombe Ave & W 150 St,40.826881,-73.941427,7,7,14
Brunswick St,40.7241765,-74.0506564,19,1,20
Hoyt St & Warren St,40.6843549,-73.98901629,27,7,34
79 St & Roosevelt Ave,40.74718,-73.88675,1,20,21
Southern Blvd & Xavier Way,40.86149,-73.88103,7,23,30
Matthews Ct & Coney Island Ave,40.64235,-73.96951,21,0,21
31 Ave & Steinway St,40.7611488,-73.9170071,0,26,26
Bailey Ave & Sedgwick Ave,40.86571,-73.90857,6,14,20
Sterling St & Bedford Ave,40.6627059,-73.9569115,15,4,19
W 160 St & St Nicholas Ave,40.834468,-73.939865,3,22,25
Faile St & Garrison Ave,40.820578,-73.888271,3,12,15
Hanson Pl & Ashland Pl,40.68506807308177,-73.97790759801863,1,31,32
E 48 St & 3 Ave,40.7546011026,-73.971878855,6,68,74
33 St & Queens Blvd,40.7443653191867,-73.93172398209572,8,15,23
Leonard St & Boerum St,40.70583339,-73.94644578,13,6,19
E 6 St & Ave B,40.72453734,-73.98185424,43,49,92
100 St & Lewis Ave,40.73988,-73.86012,11,9,20
Anderson Ave & W 164 St,40.832057,-73.927421,2,16,18
48 St & 2 Ave,40.650176,-74.015606,15,1,16
W 20 St & 8 Ave,40.74345335,-74.00004031,75,5,80
Roebling St & N 4 St,40.71469,-73.95739,8,15,23
43 St & 23 Ave,40.769673,-73.906018,14,7,21
Emerson Pl & Myrtle Ave,40.69363137,-73.96223558,21,39,60
Henry St & W 9 St,40.6763744,-74.00324957,16,0,16
90 St & 32 Ave,40.75836,-73.87824,11,9,20
Eastern Pkwy & Schenectady Ave,40.66876,-73.93376,5,17,22
81 St & 24 Ave,40.76466,-73.88803,19,0,19
E 51 St & 2 Ave,40.755293,-73.967641,3,36,39
Ithaca St & Baxter Ave,40.74638,-73.88322,5,17,22
Central Park W & W 91 St,40.788664991278836,-73.96680057048798,44,3,47
Shea Rd & Boat Basin Pl,40.75777,-73.84887,19,7,26
Jersey & 6th St,40.72528910781132,-74.04557168483734,7,7,14
Fort Washington Ave & W 173 St,40.84522,-73.940493,5,16,21
Madison St & Clinton St,40.71269042,-73.98776323,38,0,38
37 Ave & 35 St,40.7531106,-73.9279917,11,12,23
28 St & 36 Ave,40.757186,-73.932719,4,24,28
N 12 St & Bedford Ave,40.72079821,-73.95484712,25,21,46
9 Ave & W 22 St,40.7454973,-74.00197139,40,15,55
9 St & 44 Rd,40.74966,-73.9521,25,7,32
St Marks Ave & Thomas S. Boyland St,40.67313,-73.91387,12,6,18
Lewis Ave & Greene Ave,40.68995,-73.9365,17,0,17
E 178 St & Monterey Ave,40.84749,-73.89464,6,14,20
Jerome Ave & E 198 St,40.87144520687118,-73.89289632439613,9,9,18
Monroe St & Classon Ave,40.6845683,-73.95881081,5,12,17
5 Ave & E 87 St,40.78232260730881,-73.95987510681152,16,16,32
Macon St & Lewis Ave,40.68282,-73.93488,4,14,18
Nelson Ave & W 172 St,40.843965,-73.920999,6,11,17
W 82 St & Central Park W,40.78275,-73.97137,7,29,36
3 Ave & E Tremont Ave,40.84649,-73.89616,10,14,24
E New York Ave & Troy Ave,40.66227,-73.93762,19,2,21
E 11 St & Ave B,40.72746420692392,-73.97950418293476,24,40,64
Grand Concourse & E 197 St,40.86945,-73.89148,7,12,19
99 St & 38 Ave,40.75055,-73.86725,1,26,27
Steinway St & Broadway,40.75905795418586,-73.91897544264793,2,27,29
E 2 St & Ave A,40.72307749068673,-73.98583620786667,39,25,64
Myrtle Ave & Linden St,40.69943,-73.91337,4,21,25
Nostrand Ave & Rutland Rd,40.6595,-73.95041,11,8,19
Van Cleef St & 108 St,40.74096,-73.85357,14,6,20
W 47 St & 10 Ave,40.76269882,-73.99301222,32,4,36
Atlantic Ave & Furman St,40.69165183,-73.9999786,7,21,28
28 Ave & 35 St,40.7671,-73.9169858,6,20,26
40 St & Queens Blvd,40.743540273428685,-73.92435193061829,1,19,20
1 Ave & E 38 St,40.746202,-73.971822,25,10,35
Prospect Pl & Howard Ave,40.67261,-73.91977,5,11,16
5 St & 51 Ave,40.7423737,-73.9566,19,0,19
Putnam Ave & Nostrand Ave,40.68402,-73.94977,16,1,17
Sands St Gate,40.699569,-73.979827,10,3,13
28 St & 41 Ave,40.751047,-73.93797,7,16,23
Boston Rd & Prospect Ave,40.833246,-73.896599,4,13,17
41 Ave & 67 St,40.74446,-73.89764,6,14,20
Roosevelt Ave & 104 St,40.74984,-73.86156,5,13,18
Boston Rd & E 167 St,40.828199,-73.903719,1,12,13
Kingsland Ave & Nassau Ave,40.72577,-73.94173,24,0,24
National St & 45 Ave,40.74582,-73.86433,10,11,21
Windsor Pl & 8 Ave,40.660906,-73.983074,3,8,11
South Waterfront Walkway - Sinatra Dr & 1 St,40.73698221818716,-74.02778059244156,0,28,28
63 St & Borden Ave,40.72655,-73.90321,14,5,19
Clark St & Henry St,40.69760127,-73.99344559,21,17,38
31 St & 21 Ave,40.77813,-73.90842,3,22,25
Grand Concourse & E 156 St,40.823429,-73.924689,0,17,17
W 37 St & 5 Ave,40.75038009,-73.98338988,13,42,55
3 Ave & E 169 St,40.832678,-73.905158,6,14,20
Old Broadway & W 133 St,40.818212,-73.955277,8,7,15
Lafayette Ave & Stuyvesant Ave,40.6919925157634,-73.9325501024723,22,1,23
DeKalb Ave & Bedford Ave,40.690894,-73.955195,23,3,26
Brooklyn Ave & Prospect Pl,40.67412,-73.94447,5,14,19
65 Pl & 53 Ave,40.73145,-73.90022,18,1,19
Kent Ave & Grand St,40.716425,-73.96594,37,2,39
Clinton St & Union St,40.6831164,-73.99785267,35,0,35
5 Ave & W 139 St,40.815484,-73.935856,10,6,16
Lexington Ave & E 36 St,40.747573958954796,-73.9788007736206,10,7,17
60 St & 37 Ave,40.74952,-73.90265,12,5,17
25 Ave & 85 St,40.76328,-73.88404,18,1,19
Pleasant Ave & E 116 St,40.79499,-73.93333,8,13,21
Metropolitan Ave & Vandervoort Ave,40.71429,-73.93323,22,2,24
Concourse Village East & E 158 St,40.823732,-73.919379,6,17,23
Palmetto St & Traffic Ave,40.70929,-73.89441,10,8,18
E 149 St & Jackson Ave,40.813135,-73.909235,6,14,20
W 40 St & 7 Ave,40.754818,-73.988154,4,40,44
Irving Ave & Jefferson St,40.70538,-73.92535,13,4,17
W 160 St & Riverside Dr,40.83719,-73.9466,2,23,25
E 51 St & Lexington Ave,40.75714758,-73.97207836,4,68,72
Lafayette St & Grand St,40.72028,-73.99879,54,20,74
City Hall - Washington St & 1 St,40.73736,-74.03097,1,19,20
E 138 St & 5 Ave,40.81449,-73.936153,13,8,21
Wyckoff St & 3 Ave,40.6827549,-73.98258555,9,5,14
Wallabout St & Kent Ave,40.6991049,-73.960633406,5,13,18
Caton Ave & E 7 St,40.647718,-73.973663,15,1,16
Grand Concourse & E Mosholu Pkwy S,40.877964,-73.8847550291,15,6,21
Sterling Pl & New York Ave,40.67234,-73.94763,13,9,22
Broadway & W 168 St,40.84089603193041,-73.93972098827362,0,27,27
E 10 St & 2 Ave,40.72970805644994,-73.9865979552269,29,8,37
E 12 St & 3 Ave,40.73223272,-73.98889957,23,39,62
E 77 St & 1 Ave,40.77095553869235,-73.95356208096926,21,30,51
Cauldwell Ave & E 158 St,40.81989,-73.908351,2,16,18
Decatur Ave & Oliver Pl,40.867,-73.8857764,19,1,20
Maiden Ln & Pearl St,40.70706456,-74.00731853,22,3,25
Thomas S. Boyland St & Macon St,40.68491,-73.91493,9,11,20
Leonard St & Nassau Ave,40.7239567849954,-73.94984364509583,6,30,36
Plaza St East & Flatbush Ave,40.673134,-73.969106,2,61,63
W Broadway & Watts St,40.72323,-74.00314,46,4,50
W 111 St & 5 Ave,40.797520781247556,-73.9489397406578,15,5,20
Lexington Ave & E 111 St,40.7954121,-73.9441232,20,2,22
8 Ave & W 31 St,40.7505853470215,-73.9946848154068,36,52,88
E 141 St & Jackson Ave,40.806896,-73.911837,10,8,18
Bushwick Ave & Harman St,40.69356,-73.92524,14,7,21
21 St & 23 Ave,40.778557,-73.919046,19,3,22
49 Ave & 21 St,40.74252,-73.948852,11,10,21
E 188 St & Hughes Ave,40.8561,-73.88625,15,4,19
Newton Rd & 44 St,40.7595701,-73.9142678,0,17,17
Melrose Ave & E 154 St,40.819609,-73.916071,14,4,18
7 Ave S & Bleecker St,40.73213896287381,-74.00363802909851,68,5,73
Summerfield St & Cypress Ave,40.69662,-73.90056,10,6,16
Broadway & Madison St,40.68822,-73.91966,8,13,21
E 169 St & Webster Ave,40.834015,-73.908863,12,8,20
Cypress Ave & George St,40.69812,-73.90271,9,10,19
Marion Ave & Mosholu Pkwy,40.8704956,-73.8818756582,14,4,18
W 51 St & 6 Ave,40.7606597,-73.98042047,0,81,81
Patchen Ave & Bainbridge St,40.68143,-73.92565,13,5,18
92 St & 35 Ave,40.7529,-73.87536,6,19,25
1 Ave & E 6 St,40.72633085971696,-73.98616880178452,77,11,88
11 St & 44 Rd,40.749207,-73.949373,15,11,26
9 Ave & W 39 St,40.756403523272496,-73.99410143494606,6,25,31
104 St & Northern Blvd,40.75755,-73.86454,14,7,21
Tyler Ave & Maurice Ave,40.73394,-73.90128,14,4,18
E New York Ave & Utica Ave,40.662686,-73.931755,12,9,21
11 Ave & Prospect Ave,40.65629,-73.977335,16,3,19
Central Park W & W 97 St,40.79249519495111,-73.96417066463071,46,2,48
Crescent Ave & Belmont Ave,40.85391,-73.8866,17,4,21
Bronx Shore Comfort Station,40.80046,-73.92404,8,11,19
Willoughby St & Fleet St,40.69196566,-73.9813018,7,52,59
Nassau Ave & Newell St,40.724812564400175,-73.94752621650696,32,14,46
Madison Ave & E 120 St,40.80295,-73.942954,17,8,25
W 148 St & Amsterdam Ave,40.827075,-73.945909,2,19,21
43 Ave & 111 St,40.74955,-73.85464,14,2,16
DeKalb Ave & Hudson Ave,40.689888,-73.981013,56,15,71
St Johns Pl & Utica Ave,40.6705,-73.9308,11,6,17
Verona Pl & Fulton St,40.6803560840434,-73.9476791024208,10,7,17
Smith St & 3 St,40.6787242,-73.99599099,16,4,20
34 Ave & 45 St,40.754795,-73.917014,4,17,21
5 St & 6 Ave,40.6704836,-73.98208968,15,5,20
Goble Pl & Macombs Rd,40.844075,-73.917256,15,3,18
W 186 St & St Nicholas Ave,40.852253,-73.931308,8,14,22
Albany Ave & Carroll St,40.6667,-73.93972,10,7,17
61 St & Borden Ave,40.72558,-73.90417,20,1,21
Metropolitan Ave & 65 Ln,40.71225,-73.89111,14,7,21
Jefferson Ave & Evergreen Ave,40.68989,-73.91458,10,5,15
E 72 St & Park Ave,40.77118287540658,-73.96409422159195,1,38,39
University Ave & Morton Pl,40.85118155499655,-73.91465058978447,13,7,20
Rogers Pl & E 165 St,40.82388366441761,-73.8974027708582,6,13,19
Southern Blvd & E 149 St,40.811892,-73.904192,22,1,23
St Johns Pl & Washington Ave,40.6737236,-73.9631611,6,17,23
Berry St & N 8 St,40.7190095,-73.95852515,5,17,22
College Ave & E 170 St,40.837576,-73.910489,6,18,24
Steinway St & Ditmars Blvd,40.772717,-73.906127,7,13,20
Amsterdam Ave & W 73 St,40.77966809007312,-73.98093044757842,11,33,44
Garfield Pl & 8 Ave,40.6711978,-73.97484126,4,20,24
W 133 St & 12 Ave,40.820003,-73.959089,10,7,17
E 163 St & Union Ave,40.822545,-73.901824,9,13,22
Caton Ave & Bedford Ave,40.65237,-73.95623,17,0,17
Shakespeare Ave & W 169 St,40.839312,-73.922423,7,7,14
7 Ave & Central Park South,40.7667405590595,-73.9790689945221,8,73,81
Carroll St & Utica Ave,40.66619,-73.93162,7,11,18
Thomas S. Boyland St & Fulton St,40.67854,-73.91367,4,20,24
Winthrop St & Albany Ave,40.6577,-73.9398,13,5,18
Laight St & Hudson St,40.72185379,-74.00771779,45,40,85
St James Pl & Oliver St,40.71307916,-73.99851193,38,6,44
50 St & Northern Blvd,40.753441,-73.912402,5,18,23
Degraw St & 3 Ave,40.67977,-73.9847,28,0,28
Ditmars Blvd & 73 St,40.76817,-73.896293,15,3,18
W 238 St & Tibbett Ave,40.88602,-73.90232,19,1,20
Ogden Ave & Merriam Ave,40.839142,-73.925961,6,11,17
23 Ave & 27 St,40.776165,-73.9153175,13,7,20
Lexington Ave & E 24 St,40.74025878,-73.98409214,10,68,78
Withers St & Kingsland Ave,40.71773,-73.94051,17,1,18
Flatbush Ave & Fenimore St,40.65798,-73.96051,16,4,20
30 Ave & 21 St,40.7703743,-73.9286078,7,7,14
E 25 St & 1 Ave,40.7381765,-73.97738662,16,15,31
Willis Ave & E 137 St,40.808384,-73.923604,16,1,17
Green St & McGuinness Blvd,40.73396,-73.95204,11,8,19
Bedford Ave & Maple St,40.66035,-73.95679,17,4,21
Bainbridge Ave & E 198 St,40.8684871,-73.8884559781,14,6,20
82 St & 30 Ave,40.76109,-73.88632,17,1,18
Ave A & E 14 St,40.73031071000895,-73.98047178983688,3,34,37
Carroll St & Rochester Ave,40.66598,-73.9284,5,15,20
Driggs Ave & N Henry St,40.72325,-73.94308,37,19,56
Washington Ave & E 163 St,40.824,-73.91089,5,11,16
W 106 St & Central Park W,40.7981856,-73.9605909006,21,35,56
Vernon Blvd & 31 Ave,40.7692475,-73.9354504,9,12,21
Adam Clayton Powell Blvd & W 130 St,40.812346,-73.946168,11,5,16
43 Ave & 47 St,40.7448062877224,-73.91728967428207,3,23,26
Vesey Pl & River Terrace,40.7153379,-74.01658354,40,13,53
Snyder Ave & Schenectady Ave,40.65,-73.93296,6,10,16
7 Ave & 40 St,40.648169,-74.000057,8,11,19
Woodside Ave & Roosevelt Ave,40.74549,-73.90605,12,2,14
Plaza Dr & W 170 St,40.840484,-73.917946,25,1,26
S 5 Pl & S 5 St,40.710451,-73.960876,36,4,40
1 Ave & E 118 St,40.797459,-73.934499,15,8,23
24 St & 38 Ave,40.756351,-73.936515,6,11,17
Broadway & Morris St,40.705945132708806,-74.01321887969969,50,10,60
Aqueduct Ave & W 190 St,40.8649213,-73.9024238,6,13,19
Cedar Ave & W Fordham Rd,40.86156,-73.91219,13,6,19
Grand Ave & Bergen St,40.678045,-73.962408,14,10,24
Marin Light Rail,40.71458403535893,-74.04281705617905,26,0,26
Prospect Park SW & 16 St,40.657265,-73.974165,3,21,24
Grand Ave & W 181 St,40.856302,-73.907302,4,10,14
E 133 St & Cypress Pl,40.80262,-73.9174,6,10,16
Louis Nine Blvd & Intervale Ave,40.831998,-73.892686,12,3,15
Stevens - River Ter & 6 St,40.74313282710551,-74.02698867022991,3,12,15
Fort Hamilton Pkwy & E 5 St,40.649037,-73.97673,19,0,19
Berkeley Pl & 7 Ave,40.675146838709786,-73.97523209452629,26,1,27
Queens Blvd & Broadway,40.73672,-73.87728,20,2,22
E 1 St & 1 Ave,40.72335597960796,-73.98864984512329,39,28,67
Carroll St & 6 Ave,40.6740886,-73.9787282,17,5,22
S 4 St & Roebling St,40.710709,-73.959724,20,18,38
West Farms Rd & Boone Ave,40.8301283948092,-73.88630211353302,13,6,19
Washington Ave & E 167 St,40.829896,-73.907618,7,9,16
Market St & Cherry St,40.71076228,-73.99400398,34,1,35
Duffield St & Willoughby St,40.69221589,-73.9842844,6,37,43
Franklin St & W Broadway,40.71911552,-74.00666661,1,29,30
W 54 St & 9 Ave,40.76604,-73.98737,6,26,32
Frederick Douglass Blvd & W 115 St,40.8038654,-73.9559308,17,5,22
Sedgwick Ave & W 231 St,40.87512,-73.90126,14,4,18
E 97 St & 3 Ave,40.7859201,-73.94860294,12,17,29
Gerard Ave & E 165 St,40.83173,-73.922394,1,17,18
Bay St & Court St,40.671409,-74.001328,23,3,26
9 Ave & W 219 St,40.871094,-73.911503,11,6,17
Cadman Plaza E & Red Cross Pl,40.69991755,-73.98971773,5,32,37
36 St & 3 Ave,40.655716,-74.006664,26,3,29
Wythe Ave & N 13 St,40.722767,-73.957021,32,11,43
11 St & 43 Ave,40.75177,-73.94821,21,7,28
Putnam Ave & Ralph Ave,40.68705,-73.92338,11,6,17
39 St & 47 Ave,40.74215636827728,-73.92662644386292,2,14,16
Grand Concourse & E 205 St,40.875531,-73.8863864831,8,9,17
Moffat St & Bushwick,40.68458,-73.90925,5,12,17
Schermerhorn St & Hoyt St,40.6886263,-73.9851911,21,18,39
Stagg St & Union Ave,40.70877084,-73.95095259,12,17,29
41 Ave & 80 St,40.74586,-73.88539,4,17,21
Park Ave & E 162 St,40.825716,-73.915585,6,10,16
Southern Blvd & E 142 St,40.807347437082,-73.90809774398804,1,21,22
Albemarle Rd & McDonald Ave,40.645074,-73.979681,2,17,19
Walton Ave & E 151 St,40.82090903827738,-73.92753845245076,19,7,26
Stanton St & Chrystie St,40.72229346,-73.99147535,34,8,42
Pike St & E Broadway,40.71406667,-73.99293911,21,4,25
Exchange Pl,40.71636596185077,-74.034343957901,4,24,28
E 54 St & 1 Ave,40.756265,-73.964179,29,9,38
South St & Pike St,40.70991806921533,-73.99161100387573,32,0,32
Riverside Dr & W 153 St,40.832164,-73.949702,8,12,20
Sterling Pl & Schenectady Ave,40.6716,-73.93378,2,17,19
Central Park W & W 68 St,40.7734066,-73.97782542,4,36,40
E Burnside Ave & Ryer Ave,40.850535,-73.901318,4,13,17
Waterloo Pl & Crotona Park East,40.839194,-73.888587,4,15,19
Giles Pl & Fort Independence St,40.87869,-73.89862,7,11,18
Jefferson Ave & Patchen Ave,40.68609,-73.92628,12,5,17
Douglass St & 3 Ave,40.6802133,-73.98432695,24,7,31
Clinton St & Newark St,40.73743,-74.03571,10,3,13
E 187 St & 3 Ave,40.85724,-73.8909,16,2,18
Hancock St & Wyckoff Ave,40.6972,-73.90674,16,1,17
Chauncey St & Howard Ave,40.68158,-73.91959,12,4,16
W 25 St & 6 Ave,40.74395411,-73.99144871,6,44,50
Central Ave & Decatur St,40.6882,-73.90798,12,12,24
Beverley Rd & E 49 St,40.64621,-73.93067,21,0,21
Grand Concourse & E 196 St,40.86767,-73.89286,2,19,21
Murray St & West St,40.71503,-74.01246,25,35,60
E 156 St & Courtlandt Ave,40.82123860172,-73.9173299074173,7,13,20
86 St & 35 Ave,40.7523,-73.88093,13,6,19
W Tremont Ave & Grand Ave,40.850036,-73.912785,12,9,21
76 St & 45 Ave,40.7411,-73.88837,5,12,17
Crescent St & 35 Ave,40.7596276,-73.9321455,9,14,23
99 St & Astoria Blvd,40.76196,-73.87042,20,3,23
Van Vorst Park,40.71848892,-74.047726625,18,0,18
Hancock St & Bedford Ave,40.68216564,-73.95399026,14,7,21
W 54 St & 6 Ave,40.761865,-73.977242,0,62,62
Division Ave & Marcy Ave,40.70708701,-73.95796783,19,12,31
87 St & 30 Ave,40.76156,-73.88167,13,7,20
84 St & Roosevelt Ave,40.74797,-73.88204,3,24,27
6 Ave & W 33 St,40.74901271,-73.98848395,32,39,71
President St & 4 Ave,40.676757,-73.983262,21,5,26
Barclay St & Church St,40.71291224,-74.01020234,22,14,36
55 St & 7 Ave,40.639673,-74.008957,9,14,23
82 St & Broadway,40.74281,-73.88296,29,0,29
Park Ave & E 179 St,40.85014,-73.89818,19,1,20
Prospect Park West & 8 St,40.66514681533792,-73.97637605667114,0,13,13
Lincoln Pl & Nostrand Ave,40.67077,-73.9507,18,5,23
E 144 St & Brook Ave,40.811675,-73.917037,3,12,15
Bridge St & Front St,40.702969341552716,-73.98469090461731,37,1,38
7 St & 5 Ave,40.6704922,-73.98541675,23,2,25
14 St & 5 Ave,40.666287,-73.98895053,15,4,19
Eastern Pkwy & Ralph Ave,40.66852,-73.92284,14,7,21
E 44 St & Lexington Ave,40.752643,-73.974996,8,39,47
10 St & 7 Ave,40.6662078,-73.98199886,0,22,22
31 St & Hoyt Ave N,40.7711528,-73.9170074,0,32,32
Brook Ave & E 148 St,40.814383,-73.915368,5,14,19
W 135 St & Lenox Terrace Pl,40.813619,-73.939336,11,15,26
E 95 St & 3 Ave,40.7849032,-73.950503,28,1,29
Webster Ave & Ford St,40.85556,-73.89615,18,1,19
Central Ave & Weirfield St,40.69055,-73.91181,13,6,19
E 68 St & 3 Ave,40.76712840349542,-73.96224617958069,5,29,34
Centre St & Worth St,40.71494807,-74.00234482,42,65,107
Riverside Dr & W 78 St,40.78414472,-73.98362492,14,59,73
12 Ave & 36 St,40.643546,-73.986418,13,4,17
Webb Ave & W 190 St,40.8660052,-73.904254892,12,9,21
75 St & Northern Blvd,40.75473,-73.8918,5,11,16
27 Ave & 9 St,40.7739825,-73.9309134,16,20,36
Commerce St & Van Brunt St,40.6812117,-74.00860912,16,0,16
Adams St & 12 St,40.751889392240685,-74.03329162748534,14,0,14
2 Ave & E 72 St,40.7687620293096,-73.95840793848038,9,40,49
Riverside Dr & Broadway,40.865364,-73.92791,21,2,23
Union Ave & Wallabout St,40.70029511,-73.95032283,19,11,30
Riverside Dr & W 104 St,40.8013434,-73.9711457439,14,34,48
5 Ave & E 78 St,40.77632142182271,-73.96427392959595,8,31,39
Underhill Ave & Pacific St,40.6804836,-73.9646795,20,6,26
3 Ave & E 100 St,40.7877214,-73.94728331,15,10,25
Pitt St & Stanton St,40.71926081,-73.98178024,5,8,13
60 Ave & Otis Ave,40.73715,-73.85614,15,2,17
47 Ave & 31 St,40.743,-73.93561,19,8,27
Pierrepont St & Monroe Pl,40.69535693320225,-73.99344027042389,11,9,20
E 30 St & Park Ave S,40.74444921,-73.98303529,18,45,63
Amory Ct & Metropolitan Ave,40.71301,-73.90968,21,0,21
Plaza St West & Flatbush Ave,40.6750207,-73.97111473,6,25,31
Seaman Ave & Isham St,40.869898661940454,-73.92076313495636,20,3,23
Audubon Ave & Fort George Ave,40.85715781391904,-73.92717361450195,9,12,21
Congress St & Clinton St,40.68825516598005,-73.99545192718506,33,6,39
Albany Ave & Fulton St,40.6800105,-73.938475,14,10,24
E 160 St & Tinton Ave,40.820302,-73.903944,3,18,21
103 St & Martense Ave,40.74046,-73.8565,14,3,17
21 St & 43 Ave,40.75052534,-73.94594845,8,16,24
31 St & Thomson Ave,40.74469738,-73.93540375,24,23,47
31 Ave & 61 St,40.757525,-73.901614,15,3,18
Hoboken Terminal - Hudson St & Hudson Pl,40.73593758446329,-74.03030455112457,0,24,24
Broadway & W 133 St,40.8190344,-73.956156,9,9,18
Bleecker St & Crosby St,40.72615604980408,-73.99510189890862,31,29,60
Adam Clayton Powell Blvd & W 123 St,40.8078316,-73.949373,17,11,28
Greene Ave & Throop Ave,40.6894932,-73.942061,9,2,11
77 St & 31 Ave,40.75886,-73.89081,12,6,18
Macombs Pl & W 152 St,40.826406,-73.937948,4,24,28
W 120 St & Claremont Ave,40.8109494,-73.9634,13,21,34
Kingston Ave & Park Pl,40.67308,-73.94191,6,10,16
Jersey & 3rd,40.72333158646436,-74.04595255851744,8,3,11
Frost St & Meeker Ave,40.71766197083994,-73.94880026578903,2,36,38
E 47 St & Park Ave,40.75510267,-73.97498696,11,98,109
Mott St & Prince St,40.72317958,-73.99480012,21,11,32
Paulus Hook,40.7141454,-74.0335519,7,5,12
55 Ave & Center Blvd,40.740288,-73.960697,27,0,27
Perry St & Greenwich Ave,40.735918,-74.000939,35,9,44
E 75 St & 3 Ave,40.77112927,-73.95772297,6,32,38
Jackson Mill Rd & 93 St,40.75874,-73.87535,11,9,20
48 St & 37 Ave,40.751555,-73.915026,13,13,26
88 St & Astoria Blvd,40.76424,-73.8812,18,0,18
W 12 St & Hudson St,40.73752993301071,-74.00558933615685,36,7,43
Grand St & Greene St,40.72170005235607,-74.00238141417502,14,29,43
Heights Elevator,40.748715945380226,-74.04044330120087,1,17,18
Bond St & Fulton St,40.6896218879,-73.9830426872,22,18,40
E 13 St & Ave A,40.72966729392978,-73.98067966103554,28,58,86
College Ave & E 169 St,40.835122799036405,-73.91196817159653,5,14,19
5 Ave & E 63 St,40.766368,-73.971518,0,48,48
Eastern Pkwy & Kingston Ave,40.66959,-73.94237,12,17,29
Central Park North & Adam Clayton Powell Blvd,40.799484,-73.955613,32,1,33
75 St & 35 Ave,40.75091,-73.89111,11,14,25
Amsterdam Ave & W 125 St,40.813358,-73.956461,36,0,36
Marble Hill Ave & W 227 St,40.87655,-73.90941,10,3,13
Linden St & Knickerbocker Ave,40.69714,-73.91566,7,3,10
Broadway & W 41 St,40.75513557,-73.98658032,15,37,52
20 Ave & Shore Blvd,40.785994,-73.915098,4,15,19
Sterling Pl & Ralph Ave,40.67095,-73.92222,2,14,16
W 116 St & Amsterdam Ave,40.8067581,-73.9607082,6,32,38
E 68 St & Madison Ave,40.7691572,-73.96703464,8,50,58
17 St & 5 Ave,40.663493,-73.991007,17,1,18
St Nicholas Ave & W 157 St,40.832314,-73.94102,3,12,15
Broadway & E 19 St,40.73829,-73.99006,15,81,96
Aqueduct Ave & North St,40.8604787,-73.9057169936,5,12,17
3 Ave & 17 St,40.666168,-73.995549,19,0,19
Bridge St & York St,40.70133448066992,-73.98471236228943,47,6,53
E 48 St & Tilden Ave,40.64795,-73.93182,12,16,28
Halsey St & Tompkins Ave,40.6823687,-73.944118,16,0,16
85 St & Northern Blvd,40.75601,-73.88266,7,11,18
E 189 St & Bathgate Ave,40.85859,-73.88821,15,4,19
Wythe Ave & Metropolitan Ave,40.716887,-73.963198,41,9,50
10 Ave & W 215 St,40.86932465640094,-73.91519755125046,12,7,19
Lee Ave & Taylor St,40.706732,-73.961241,18,4,22
2 Ave & E 96 St,40.7839636,-73.9471673,37,3,40
Columbia Heights & Cranberry St,40.70037867,-73.99548059,9,27,36
Bergen St & Smith St,40.6867443,-73.99063168,43,0,43
44 St & 2 Ave,40.652502,-74.013587,17,1,18
E 32 St & Park Ave,40.7457121,-73.98194829,3,47,50
West Drive & Prospect Park West,40.6610633719006,-73.97945255041122,4,17,21
W 41 St & 8 Ave,40.75640548,-73.9900262,57,41,98
Nagle Ave & Thayer St,40.861382,-73.925591,23,7,30
Broad St & Bridge St,40.70365182,-74.01167797,17,30,47
Bergen Ave,40.722103786686034,-74.07145500183105,10,0,10
E 182 St & Belmont Ave,40.85089,-73.88793,3,19,22
Monitor St & Meeker Ave,40.721226,-73.941845,12,8,20
25 Ave & 41 St,40.767666,-73.910963,2,19,21
Claflin Ave & Reservoir Ave,40.87398,-73.89943,16,3,19
Roosevelt Island Tramway,40.757284,-73.9536,33,0,33
McGinley Square,40.7253399253558,-74.06762212514877,5,17,22
59 St & 41 Ave,40.744577,-73.905986,18,0,18
4 Ave & 9 St,40.6705135,-73.98876585,27,1,28
Morris Ave & E Burnside Ave,40.85322,-73.90546,16,3,19
55 St & 5 Ave,40.642408,-74.013318,3,25,28
Liberty St & Nassau St,40.70858894,-74.00935482,11,33,44
30 Ave & 70 St,40.76013,-73.89741,15,1,16
Wyckoff Ave & Gates Ave,40.699871408829885,-73.91171872615814,6,26,32
President St & Henry St,40.6828003,-73.99990419,24,0,24
Division St & Bowery,40.71419,-73.99673,35,5,40
57 Ave & 98 Pl,40.73802,-73.86103,18,7,25
Bank St & Hudson St,40.73652889,-74.00618026,19,7,26
Clinton St & 7 St,40.74542,-74.03332,12,6,18
Corona Ave & 111 St,40.7408,-73.84978,22,0,22
Bushwick Ave & Powers St,40.71247661,-73.94100005,8,19,27
Chauncey St & Stuyvesant Ave,40.68012,-73.93168,4,20,24
41 Ave & 77 St,40.74557,-73.8882,0,21,21
Morningside Dr & Amsterdam Ave,40.81028506306003,-73.95736455917358,3,26,29
Kane St & Clinton St,40.6861758,-73.99645295,26,1,27
Centre St & Chambers St,40.71273266,-74.0046073,17,34,51
Fulton Ave & St Paul's Pl,40.83545,-73.90153,4,11,15
Clermont Ave & Park Ave,40.69573398,-73.97129668,15,0,15
91 St & 23 Ave,40.76768,-73.87899,21,1,22
Audubon Ave & W 192 St,40.85589030603889,-73.92708241939545,3,15,18
Queens Blvd & Albion Ave,40.73856,-73.88553,15,5,20
34 Ave & Junction Blvd,40.75502,-73.87285,20,1,21
Lefferts Ave & Schenectady Ave,40.66343,-73.93472,23,4,27
Nassau St & Navy St,40.69839895,-73.98068914,54,3,57
14 St & 7 Ave,40.663779,-73.98396846,11,3,14
Marcus Garvey Blvd & Macon St,40.682601,-73.938037,3,13,16
St Nicholas Ave & W 137 St,40.818477,-73.947568,7,14,21
Crotona Park East & E 173 St,40.837037,-73.890413,2,16,18
34 St & 35 Ave,40.7569332,-73.9262231,7,11,18
Brooklyn Ave & Snyder Ave,40.64915,-73.94368,12,9,21
E 40 St & 5 Ave,40.752062307,-73.9816324043,20,69,89
37 Ave & 63 St,40.74893,-73.89981,10,11,21
4 St & Grand St,40.7422579775645,-74.03511106967926,8,10,18
Harlem River Dr & W 155 St,40.830476,-73.939929,9,9,18
W 43 St & 10 Ave,40.76009437,-73.99461843,24,87,111
50 St & Barnett Ave,40.750097682094825,-73.91349703073502,7,13,20
W 52 St & 11 Ave,40.76727216,-73.99392888,28,23,51
6 St & Grand St,40.744397833095604,-74.03450086712837,9,8,17
4 Ave & 17 St,40.665507,-73.993037,21,0,21
Fort Hamilton Pkwy & E 2 St,40.648005,-73.979342,12,3,15
Montrose Ave & Bushwick Ave,40.70767788,-73.94016171,12,26,38
Montague St & Clinton St,40.6942715,-73.9923272,4,36,40
Willoughby Ave & Myrtle Ave,40.69757,-73.93098,14,4,18
Wadsworth Ave & W 175 St,40.846052,-73.937648,0,19,19
Sedgwick Ave & Hall of Fame Terrace,40.859532,-73.913303,1,16,17
98 St & 25 Ave,40.76454,-73.87171,17,1,18
Grand St & 14 St,40.75409,-74.0316,4,14,18
Park Ave & E 41 St,40.751581,-73.97791,16,90,106
Jerome Ave & E 181 St,40.855653,-73.905528,9,7,16
MacDonough St & Malcolm X Blvd,40.68273,-73.92926,17,3,20
Kent Ave & Division Ave,40.706563674670925,-73.9683187007904,34,4,38
Bailey Ave & W 234 St,40.88066,-73.90076,20,1,21
58 St & Pier 4,40.646475,-74.026081,14,12,26
W 51 St & 7 Ave,40.76167,-73.98256,4,71,75
Rockaway Ave & Bainbridge St,40.68319988172761,-73.91166642308235,4,14,18
Benham St & Roosevelt Ave,40.74841,-73.8751,1,23,24
Naples Terrace & Godwin Terrace,40.87995,-73.90536,21,0,21
Cherry St,40.71219906,-73.97948148,17,18,35
73 St & 25 Ave,40.76205,-73.895,17,2,19
Lexington Ave & Classon Ave,40.68676793,-73.95928168,2,14,16
2 Ave & E 31 St,40.74299,-73.97711,8,66,74
Broadway & W 38 St,40.7529728216068,-73.98734897375107,2,56,58
Bainbridge Ave & E 193 St,40.86415477605928,-73.892452880543,16,10,26
Norfolk St & Broome St,40.7172274,-73.98802084,37,9,46
34 Ave & 21 St,40.7628138,-73.9342862,12,10,22
Central Park W & W 76 St,40.77896784,-73.97374737,7,29,36
Park Pl & Thomas S. Boyland St,40.67154,-73.91433,12,11,23
Coffey St & Ferris St,40.67818387977647,-74.0170168876648,14,7,21
100 St & Humphreys St,40.76574,-73.87012,18,1,19
8 St & Astoria Blvd,40.7725996921817,-73.93266275525093,14,4,18
Jackson Mill Rd & 24 Ave,40.76619,-73.87561,14,6,20
Nostrand Ave & Myrtle Ave,40.69527008,-73.95238108,17,5,22
Jerome Ave & Ogden Ave,40.829797,-73.931015,12,8,20
Walton Ave & E 171 St,40.840683,-73.915073,1,15,16
Van Brunt St & Van Dyke St,40.6758329439129,-74.01472628116608,2,16,18
7 Ave & Park Pl,40.6776147,-73.97324283,15,8,23
25 Ave & 96 St,40.76447,-73.87369,20,0,20
Grand Concourse & E 161 St,40.82713380423556,-73.9227358996868,5,18,23
W 37 St & 10 Ave,40.75660359,-73.9979009,11,26,37
St James Ave & 51 Ave,40.73813,-73.88104,17,2,19
Lexington Ave & E 120 St,40.8013066,-73.9398167,12,11,23
Washington Pl & 6 Ave,40.73224119,-74.00026394,45,26,71
E 155 St & Courtlandt Ave,40.82057,-73.917579,10,7,17
Lenox Ave & W 130 St,40.8107922,-73.9430681,12,11,23
Water St & Fletcher St,40.706410755236135,-74.00559738278389,64,9,73
W 163 St & Riverside Dr,40.839278,-73.945446,9,9,18
Rogers Ave & Lincoln Rd,40.66127,-73.95352,7,13,20
Kingston Ave & Herkimer St,40.67890679,-73.94142771,11,8,19
Broadway & W 58 St,40.76695317,-73.98169333,3,74,77
11 Ave & W 41 St,40.76030096,-73.99884222,42,1,43
35 St & 23 Ave,40.77301508291382,-73.91119033098221,9,16,25
Freeman St & Southern Blvd,40.830051,-73.892103,10,12,22
Underhill Ave & Lincoln Pl,40.6740123,-73.9671457,17,7,24
Lexington Ave & E 127 St,40.805726,-73.936322,11,11,22
S 2 St & Kent Ave,40.714731,-73.966612,37,8,45
Seaman Ave & Beak St,40.867505,-73.926363,11,8,19
E 97 St & Madison Ave,40.787801,-73.953559,15,18,33
Audubon Ave & W 179 St,40.847305,-73.933291,7,10,17
Maple St & Albany Ave,40.66155,-73.93974,17,1,18
Rugby Rd & Albemarle Rd,40.64672,-73.96637,15,2,17
Carlton Ave & Greene Ave,40.685957,-73.971468,12,11,23
Cypress Ave & St Felix Ave,40.69559,-73.89927,5,15,20
Bleecker St & Forest Ave,40.7107,-73.90525,7,11,18
Stanton St & Norfolk St,40.720747,-73.986274,37,9,46
Flushing Ave & Vanderbilt Ave,40.697950315695444,-73.97077560424805,15,5,20
Jackson Square,40.71113,-74.0789,3,13,16
W 15 St & 7 Ave,40.73935542,-73.99931783,28,44,72
48 Ave & 37 St,40.74034668087185,-73.92886072397232,4,13,17
Great Jones St,40.72743423,-73.99379025,4,18,22
E 47 St & 2 Ave,40.75323098,-73.97032517,7,92,99
Ocean Ave & Tennis Ct,40.64873,-73.96084,14,9,23
W 42 St & 8 Ave,40.7575699,-73.99098507,29,7,36
2 Ave & 36 St,40.65708866668485,-74.00870203971863,41,0,41
W 44 St & 5 Ave,40.75500254,-73.98014437,24,40,64
99 St & 50 Ave,40.74278,-73.86226,8,12,20
W 43 St & 6 Ave,40.75527307,-73.98316936,4,53,57
48 St & 50 Ave,40.73737,-73.91803,9,7,16
Eastern Pkwy & Franklin Ave (SW Corner),40.670529,-73.958222,0,20,20
39 Ave & 45 St,40.749478221834764,-73.91826465725897,6,11,17
34 St & 5 Ave,40.654098,-74.001131,18,1,19
E 4 St & 2 Ave,40.7262807,-73.98978041,52,23,75
W Tremont Ave & Montgomery Ave,40.851788,-73.916418,2,17,19
8 Ave & W 49 St,40.76171227910671,-73.98655101656914,10,41,51
W 63 St & Broadway,40.77163851,-73.98261428,4,24,28
Madison St & 1 St,40.73879,-74.0393,18,0,18
Amsterdam Ave & W 162 St,40.83618,-73.939789,4,19,23
27 St & Hunter St,40.7485,-73.941275,21,12,33
Madison Ave & E 51 St,40.75863,-73.97513,2,41,43
Franklin Ave & Myrtle Ave,40.694546087246025,-73.95801365375519,19,5,24
Halsey St & Ralph Ave,40.68494,-73.92299,17,0,17
34 Ave & 71 St,40.75257,-73.89538,14,6,20
W 54 St & 11 Ave,40.768333,-73.992573,23,34,57
Union Ave & E 169 St,40.82995,-73.898802,8,7,15
Pacific St & Nostrand Ave,40.6776,-73.94963,14,1,15
Newport Pkwy,40.7287448,-74.0321082,5,7,12
Rivington St & Ridge St,40.71850211,-73.98329859,40,15,55
Stuyvesant Ave & Hart St,40.69465,-73.9343,16,7,23
43 St & Skillman Ave,40.74692675687384,-73.9208248257637,5,13,18
W 24 St & 7 Ave,40.74487634,-73.99529885,29,48,77
E 132 St & Madison Ave,40.810224,-73.937195,8,10,18
44 St & Greenpoint Ave,40.741119944681465,-73.92103672027588,16,11,27
31 Ave & 57 St,40.757357,-73.904726,8,15,23
E 53 St & Lexington Ave,40.75828065,-73.97069431,1,44,45
Duane St & Hudson St,40.71703,-74.00925,38,2,40
E Tremont Ave & E 176 St,40.847798,-73.901883,10,8,18
E 102 St & Park Ave,40.7904828,-73.95033068,23,7,30
Henry St & Bay St,40.6725058,-74.00494695,13,5,18
Crotona Ave & E 183 St,40.85157,-73.88475,15,9,24
Schenectady Ave & Pacific St,40.67686,-73.93327,12,6,18
E 56 St & Madison Ave,40.761573,-73.972628,1,27,28
W 155 St & Frederick Douglass Blvd,40.82923,-73.936996,25,6,31
Icahn Stadium Plaza,40.79322,-73.92396,15,1,16
Monroe St & 11 St,40.7501091128573,-74.036636745998,16,4,20
Greenwich St & W Houston St,40.728846,-74.008591,66,14,80
Columbia St & Rivington St,40.71739973,-73.98016555,28,12,40
DeKalb Ave & S Portland Ave,40.68967018552252,-73.97527355121376,12,10,22
Catherine St & Monroe St,40.71117444,-73.99682619,34,0,34
Cliff St & Fulton St,40.70838,-74.00495,29,33,62
Fairmount Ave,40.72572613742557,-74.07195925712585,3,14,17
Suffolk St & Stanton St,40.72066442,-73.98517977,68,7,75
E Mosholu Pkwy & Van Cortlandt Ave E,40.87656,-73.88366,21,1,22
E 147 St & Bergen Ave,40.814673,-73.91839,8,13,21
E 138 St & Grand Concourse,40.813224,-73.930605,2,15,17
46 St & 6 Ave,40.645921,-74.005708,5,13,18
St Ann's Ave & E 144 St,40.811112,-73.914932,9,9,18
31 St & Northern Blvd,40.75186951421875,-73.93349289894103,0,35,35
Riverside Dr & W 91 St,40.79313480986663,-73.97700369358063,24,28,52
Christopher St & Greenwich St,40.73291553,-74.00711384,67,3,70
Washington Pl & Greene St,40.72980619180496,-73.99546380915461,17,24,41
Franklin Ave & E 169 St,40.83171,-73.90208,1,13,14
E 170 St & Clay Ave,40.837213,-73.908345,0,17,17
Gerard Ave & E 146 St,40.817755,-73.92965,10,9,19
Dixon Mills,40.721630142638354,-74.04996782541275,16,1,17
5 Ave & 3 St,40.6728155,-73.98352355,29,0,29
Woodward Ave & Harman St,40.70793,-73.91092,9,10,19
Grove St & Fresh Pond Rd,40.71032,-73.89955,6,8,14
N 5 St & Wythe Ave,40.718389,-73.961501,37,1,38
Columbia St & W 9 St,40.6769993,-74.00647134,20,0,20
Columbia St & Degraw St,40.6859296,-74.00242364,17,0,17
Clay Ave & Claremont Pkwy,40.83999,-73.90549,18,0,18
Madison Ave & E 99 St,40.78948541553215,-73.95242929458618,10,21,31
Washington St & Gansevoort St,40.739323,-74.008119,8,29,37
St Marks Pl & 2 Ave,40.7284186,-73.98713956,60,10,70
Lincoln Pl & Classon Ave,40.6721683,-73.9609,2,19,21
Keegan Rd & 2 Ave,40.64243139706092,-74.0255355834961,27,8,35
Lexington Ave & E 26 St,40.741459,-73.983293,10,70,80
Broadway & W 185 St,40.852538,-73.93441,9,6,15
Lenox Ave & W 133 St,40.81296,-73.941878,14,10,24
Bergen St & Troy Ave,40.67524,-73.93596,2,18,20
Atlantic Ave & Fort Greene Pl,40.68382604,-73.97632328,14,47,61
E 128 St & 3 Ave,40.805631,-73.934077,10,2,12
St Nicholas Ave & W 134 St,40.816234,-73.948222,8,12,20
E 106 St & Madison Ave,40.7934337,-73.94945003,14,5,19
Lafayette Park,40.71346382669195,-74.06285852193832,12,1,13
Lincoln Ave & E 134 St,40.808484,-73.928803,2,12,14
Intervale Ave & Kelly St,40.827301,-73.896372,13,7,20
W 30 St & 8 Ave,40.74965268472847,-73.9952078461647,57,8,65
3 Ave & E 71 St,40.76879,-73.9614,3,39,42
53 St & 4 Ave,40.644862,-74.014531,11,12,23
10 Ave & W 28 St,40.75066386,-74.00176802,12,32,44
Goulden Ave & Bedford Park Blvd,40.87387,-73.89533,9,8,17
Bushwick Ave & Dekalb Ave,40.69502,-73.92825,11,16,27
West Thames St,40.70834698,-74.01713445,60,6,66
Allen St & Stanton St,40.722055,-73.989111,29,12,41
W 21 St & 6 Ave,40.74173969,-73.99415556,6,62,68
E 63 St & 3 Ave,40.763954,-73.9646,4,53,57
Grand Concourse & E 192 St,40.86448,-73.89522,2,18,20
Skillman Ave & 43 Ave,40.74653761978055,-73.93215849995613,7,10,17
Ogden Ave & W 164 St,40.832812,-73.929372,12,7,19
30 Ave & 80 St,40.76109,-73.88838,19,0,19
E 14 St & Ave B,40.72938685,-73.97772429,38,2,40
34 Ave & 31 St,40.759604471387945,-73.92714411020279,12,5,17
Jefferson St & Cypress Ave,40.70907,-73.92157,16,8,24
93 St & Roosevelt Ave,40.74888,-73.87368,0,24,24
E 5 St & Ave A,40.72479007746337,-73.98430064320564,31,8,39
111 St & 53 Ave,40.74336,-73.85129,14,9,23
Irving Ave & Halsey St,40.69467,-73.90663,4,14,18
Intervale Ave & Westchester Ave,40.821967,-73.896752,23,2,25
Gansevoort St & Hudson St,40.73937600789778,-74.00520807425661,105,11,116
34 Ave & 113 St,40.75696,-73.85612,15,5,20
45 Ave & 21 St,40.74737075646803,-73.94777297973631,9,11,20
Onderdonk Ave & Dekalb Ave,40.70863,-73.91497,15,0,15
W 168 St & Fort Washington Ave,40.84210236102173,-73.9422395825386,0,41,41
Center Blvd & 51 Ave,40.743366080270214,-73.95960688591003,14,8,22
Myrtle Ave & Marcy Ave,40.69539817,-73.94954908,5,17,22
E 167 St & Clay Ave,40.83094,-73.91125,25,1,26
79 St & 37 Ave,40.74937,-73.88714,8,12,20
Reade St & Broadway,40.71450451,-74.00562789,13,46,59
Crotona Ave & E 179 St,40.84666,-73.88991,11,8,19
Nevins St & Schermerhorn St,40.68737247650719,-73.98176059126854,2,21,23
Menahan St & Seneca Ave,40.70461,-73.91054,2,12,14
Park Ave & E Tremont Ave,40.84731,-73.89981,24,0,24
60 St & 60 Rd,40.71592232709503,-73.90601366758347,6,10,16
Adam Clayton Powell Blvd & W 151 St,40.825289,-73.936232,9,7,16
Allen St & Hester St,40.71606,-73.99191,100,7,107
Carlton Ave & Dean St,40.6809741,-73.9710097,16,9,25
Lincoln Rd & Ocean Ave,40.6605,-73.9626,7,12,19
Fresh Pond Rd & Eliot Ave,40.71442,-73.90097,3,16,19
Broadway & Van Cortlandt Park S,40.8863,-73.8997,31,0,31
E 98 St & Park Ave,40.78813,-73.95206,8,14,22
Lincoln Park,40.7246050998869,-74.07840594649315,14,2,16
Stanhope St & Fairview Ave,40.70998,-73.91116,12,4,16
Westchester Ave & Longwood Ave,40.819701,-73.901311,0,19,19
Dean St & Hoyt St,40.6864442,-73.98759104,62,9,71
Pearl St & York St,40.70140463410644,-73.98768022656441,45,4,49
W 34 St & Hudson Blvd E,40.75516719072139,-74.00059908628464,1,50,51
W 48 St &  Rockefeller Plaza,40.75776935448309,-73.97929430007935,3,52,55
E 3 St & Church Ave,40.643817,-73.977433,2,17,19
6 Ave & Canal St,40.72243797,-74.00566443,32,33,65
72 St & 41 Ave,40.7448,-73.89377,4,22,26
Willoughby St & Ashland Pl,40.69178,-73.97877,19,12,31
4 St & River St,40.7408139,-74.0274062,1,12,13
Goulden Ave & W 197 St,40.87156,-73.89714,13,7,20
34 Ave & 89 St,40.75437,-73.87833,11,14,25
56 St & Arnold Ave,40.71484,-73.909,7,14,21
55 Ave & 97 Pl,40.73892,-73.86367,6,10,16
43 St & 37 Ave,40.750181,-73.919998,1,20,21
34 Ave & 38 St,40.75717,-73.92175,21,5,26
Greene St & Prince St,40.72511734422387,-73.99930492043495,12,29,41
Grand Concourse & E 184 St,40.85941,-73.8985,11,9,20
29 St & 5 Ave,40.656986,-73.998194,10,0,10
12 Ave & W 125 St,40.818299,-73.960405,31,3,34
E 85 St & 3 Ave,40.77801203,-73.95407149,32,7,39
St Nicholas Ave & W 126 St,40.8114323,-73.9518776,30,3,33
Sedgwick Ave & Giles Pl,40.88111,-73.8965,6,14,20
9 St HBLR - Jackson St & 8 St,40.74790720968899,-74.03841152787209,9,9,18
St Marks Pl & 4 Ave,40.68197,-73.98034,3,18,21
Fulton St & Waverly Ave,40.683238654603414,-73.96599590778351,5,20,25
Jerome Ave & E 164 St,40.831444,-73.926226,19,2,21
Bayard St & Baxter St,40.71602118,-73.99974372,19,19,38
7 Ave & 41 St,40.647379,-74.000911,7,14,21
Broadway & W 122 St,40.8120562,-73.9612547,12,13,25
Cambridge Pl & Gates Ave,40.68488,-73.96304,16,1,17
Adam Clayton Powell Blvd & W 138 St,40.81695971032464,-73.9422959089279,4,17,21
99 St & 32 Ave,40.75896,-73.86976,14,6,20
Decatur St & Saratoga Ave,40.68332,-73.91711,8,10,18
Lefferts Ave & Albany Ave,40.66288,-73.94019,16,5,21
4 Ave & 3 St,40.673746,-73.985649,39,0,39
W 84 St & Amsterdam Ave,40.78621,-73.9756,11,46,57
University Ave & W 168 St,40.838706,-73.927034,16,1,17
Beck St & Leggett Ave,40.815077,-73.899939,12,4,16
31 Pl & Hunters Point Ave,40.74021356884924,-73.93537044525146,6,11,17
3 Ave & Franklin Ave,40.82696,-73.907451,4,13,17
E Tremont Ave & Jerome Ave,40.851747,-73.908964,9,9,18
Cabrini Blvd & W 177 St,40.848282,-73.941343,3,20,23
Flatbush Ave & Eastern Pkwy,40.668757,-73.966438,7,16,23
E 11 St & 1 Ave,40.72953837,-73.98426726,45,8,53
Hope St & Union Ave,40.71167351,-73.95141312,10,6,16
Lawrence St & Willoughby St,40.69236178,-73.98631746,7,27,34
Bergen Ave & Stegman St,40.70657545063453,-74.0867006778717,16,3,19
W 35 St & 8 Ave,40.752762088742045,-73.99280458705107,18,26,44
Prospect Ave & Greenwood Ave,40.651745,-73.975988,16,1,17
Morris Ave & E 153 St,40.820036,-73.921411,12,7,19
India St Pier,40.731734785883454,-73.9612390102593,42,7,49
Adam Clayton Powell Blvd & W 141 St,40.819241,-73.941057,14,7,21
Dock St & Front St,40.702709,-73.99253,25,0,25
E 20 St & Park Ave,40.73827428,-73.98751968,6,20,26
Pearl St & Whitehall St,40.703144,-74.013178,16,28,44
E 118 St & 3 Ave,40.799139,-73.9389152,11,17,28
Winthrop St & Rogers Ave,40.65686,-73.95331,11,8,19
34 Ave & 13 St,40.7638753,-73.9364848,9,10,19
Central Park S & 6 Ave,40.76590936,-73.97634151,11,58,69
6 Ave & Broome St,40.72431,-74.00473,50,18,68
W 16 St & The High Line,40.74334935,-74.00681753,39,18,57
Fulton St & Clermont Ave,40.68415748,-73.96922273,12,61,73
E 27 St & 1 Ave,40.739445,-73.976806,15,67,82
46 Rd & 11 St,40.745805,-73.950752,15,9,24
Van Dam St & Meeker Ave,40.72532,-73.9368,11,18,29
Irving Ave & Harman St,40.70108,-73.9179,13,5,18
St Ann's Ave & Westchester Ave,40.815887,-73.911918,6,10,16
Cooper Square & Astor Pl,40.72951496224949,-73.99075269699097,40,43,83
Astoria Park S & Shore Blvd,40.7767,-73.927631,24,8,32
Myrtle Ave & 65 St,40.70117,-73.8904,12,4,16
S 4 St & Wythe Ave,40.71285887,-73.96590294,29,4,33
St Nicholas Ave & W 150 St,40.827212,-73.942722,2,23,25
35 Ave & 10 St,40.76315481910373,-73.93985509872437,17,7,24
Amsterdam Ave & W 79 St,40.7829391,-73.9786517,9,30,39
New York Ave & Lenox Rd,40.65458,-73.94716,1,22,23
Washington St & Laight St,40.72231,-74.0106,38,20,58
Essex Light Rail,40.7127742,-74.0364857,5,15,20
E 19 St & Beverley Rd,40.64483,-73.9613,19,0,19
Ditmars Blvd & 102 St,40.76894,-73.86832,22,0,22
111 St & Roosevelt Ave,40.75147,-73.8557,16,4,20
W 33 St & 10 Ave,40.753773368360385,-73.99937599897385,15,45,60
Riverside Dr & W 145 St,40.827305,-73.951989,10,18,28
Bedford Park Blvd & Paul Ave,40.87444,-73.89186,9,14,23
President St & Hoyt St,40.680057,-73.991753,20,2,22
Bushwick Ave & Forrest St,40.70076,-73.93641,15,1,16
Prospect Ave & E 167 St,40.826303,-73.898751,10,9,19
Morgan Ave & Lombardy St,40.72226,-73.93889,17,9,26
N 15 St & Wythe Ave,40.724055,-73.955736,43,9,52
41 St & 4 Ave,40.651354,-74.007168,16,1,17
N 5 St & Northside Piers,40.719876,-73.963865,35,1,36
94 St & 57 Ave,40.73628,-73.86752,23,0,23
Empire Blvd & New York Ave,40.66403,-73.94769,13,10,23
34 Ave & 108 St,40.75614,-73.86084,9,12,21
Madison St & Forest Ave,40.70555,-73.90245,7,14,21
Rutland Rd & E 45 St,40.66034,-73.93618,20,0,20
42 Ave & 108 St,40.74944,-73.85792,10,9,19
Bergen Ave & E 152 St,40.817166,-73.914737,8,7,15
57 Rd & 59 St,40.72249,-73.90854,13,4,17
Van Brunt St & Wolcott St,40.6773429,-74.01275056,17,9,26
Prospect Park SW & Greenwood Ave,40.652563,-73.972573,26,4,30
W Broadway & Spring St,40.72494672359416,-74.00165855884552,38,22,60
Amsterdam Ave & W 152 St,40.829523,-73.944279,6,14,20
5 Ave & 41 St,40.649983,-74.005144,19,1,20
E 6 St & Ave D,40.72228087,-73.97668709,31,11,42
23 St & 31 Ave,40.76663971723091,-73.9286595582962,8,9,17
LaGuardia Pl & W 3 St,40.72917025,-73.99810231,30,7,37
Mercer St & Bleecker St,40.72706363348306,-73.99662137031554,33,24,57
E 165 St & Clay Ave,40.82809,-73.91288,11,5,16
Walker St & Baxter St,40.717411,-73.999573,27,8,35
W 17 St & 7 Ave,40.740564236339516,-73.99852573871613,12,33,45
W 204 St & Nagle Ave,40.863211,-73.920827,12,4,16
Harrison St & Hudson St,40.71870987,-74.0090009,10,27,37
Stanton St & Mangin St,40.71782143,-73.97628939,14,0,14
104 St & 38 Ave,40.75138,-73.86242,13,6,19
Morton St & Greenwich St,40.73115,-74.00887,54,1,55
Pacific St & Nevins St,40.6853761,-73.98302136,9,7,16
Grand Concourse & E Mount Eden Ave,40.84301,-73.91172,1,15,16
48 St & Barnett Ave,40.750016404259334,-73.91540944576263,7,7,14
Kingsbridge Terrace & W 230 St,40.87555,-73.90212,8,10,18
E 34 St & Church Ave,40.65116,-73.94577,9,16,25
Rutland Rd & Brooklyn Ave,40.65969,-73.94517,25,0,25
90 St & 51 Ave,40.73937,-73.87411,10,6,16
Front St & Pine St,40.70531,-74.00613,9,40,49
Washington Park,40.6917823,-73.9737299,8,14,22
Madison St & Evergreen Ave,40.69122,-73.91693,17,0,17
Jerome Ave & Bedford Park Blvd E,40.87307,-73.88971,11,12,23
Greenwich Ave & Charles St,40.735238,-74.000271,41,14,55
E 67 St & Park Ave,40.76780080148132,-73.96592080593109,1,37,38
Prospect Park SW & Vanderbilt St,40.65482,-73.973217,22,13,35
N Henry St & Norman Ave,40.7277,-73.94395,14,14,28
Willoughby Ave & Walworth St,40.69331716,-73.95381995,12,1,13
MacDougal St & Prince St,40.72710258,-74.00297088,47,6,53
Broadway & Kent Ave,40.710888,-73.968329,26,4,30
Warren St & Court St,40.686371,-73.99383324,14,9,23
Carlton Ave & Flushing Ave,40.697787,-73.973736,36,6,42
Caton Ave & Argyle Rd,40.649681,-73.967829,13,8,21
Prospect Ave & Vanderbilt St,40.653368,-73.976291,10,10,20
107 St & 32 Ave,40.75996,-73.86224,18,0,18
Willoughby Ave & Onderdonk Ave,40.7098,-73.91727,22,3,25
New York Ave & Montgomery St,40.66509,-73.94824,1,16,17
MacDougal St & Washington Sq,40.73226398,-73.99852205,13,15,28
Greenwich Ave & 8 Ave,40.7390169121,-74.0026376103,59,5,64
Union Ave & N 12 St,40.71924,-73.95242,22,13,35
Courtlandt Ave & E 149 St,40.816402,-73.919549,0,17,17
Madison St & Seneca Ave,40.70183,-73.90625,4,17,21
St James Pl & Pearl St,40.71117416,-74.00016545,23,2,25
56 Ave & 92 St,40.73649,-73.86995,23,0,23
30 St & 48 Ave,40.7413272,-73.937999,17,11,28
Sigourney St & Columbia St,40.67267243410948,-74.0087952464819,9,4,13
Parkside Ave & Flatbush Ave,40.65563,-73.95968,24,0,24
Kingston Ave & Montgomery St,40.66481,-73.94269,8,9,17
Clinton Ave & Myrtle Ave,40.693261,-73.968896,27,1,28
E 39 St & Lexington Ave,40.749498546025194,-73.97729203113158,21,40,61
Andrew Ave N & Hall of Fame Tce,40.85834,-73.91008,2,17,19
W 64 St & Thelonious Monk Circle,40.77515953434235,-73.98918695747852,24,16,40
Warren St,40.7211236,-74.03805095,12,8,20
Bergen St & Mother Gaston Blvd,40.67374,-73.90852,21,3,24
E 161 St & Park Ave,40.824811,-73.916407,10,6,16
Steinway St & 23 Ave,40.7713937,-73.9077436,4,15,19
Evergreen Ave & Noll St,40.70106,-73.93318,21,1,22
1 Ave & E 110 St,40.7923272,-73.9383,18,0,18
3 Ave & E 170 St,40.834857,-73.903743,9,9,18
W 176 St & Montgomery Ave,40.849629,-73.919205,2,16,18
W 51 St & Rockefeller Plaza,40.75973805251143,-73.97811613976955,0,49,49
29 St & 40 Ave,40.75217,-73.93588,1,18,19
Verveelen Pl & Broadway,40.87826,-73.90508,20,1,21
Calyer St & West St,40.72693,-73.95863,22,9,31
Monroe St & Bedford Ave,40.6851443,-73.95380904,8,6,14
E 18 St & Church Ave,40.64958,-73.96316,4,22,26
Jackson St & Leonard St,40.71638031973561,-73.94821286201477,9,11,20
Cortelyou Rd & Albany Ave,40.64483,-73.93853,5,13,18
E 5 St & Ave C,40.72299208,-73.97995466,49,3,52
E 72 St & York Ave,40.76663814,-73.95348296,11,21,32
Fulton St & Williams Ave,40.67709,-73.9008,12,8,20
W 159 St & Edgecombe Ave,40.833303,-73.939326,2,15,17
Edgecombe Ave & W 145 St,40.823498,-73.94386,3,25,28
65 St & 35 Ave,40.75053,-73.8977,15,10,25
Hudson St & W 13 St,40.74005708567285,-74.0052741765976,23,18,41
Greenpoint Ave & Manhattan Ave,40.73026,-73.95394,12,12,24
61 St & Queens Blvd,40.74091,-73.90273,17,9,26
Driggs Ave & Lorimer St,40.72179134,-73.9504154,13,11,24
10 St & 2 Ave,40.671907,-73.993612,15,0,15
Hudson St & N Moore St,40.719887998,-74.0086269379,47,22,69
N 7 St & Driggs Ave,40.716967,-73.956388,2,50,52
57 St & 43 Ave,40.74324,-73.908,7,9,16
1 Ave & E 44 St,40.75001986,-73.96905301,14,68,82
Amsterdam Ave & W 186 St,40.851113,-73.928808,1,17,18
Manila & 1st,40.721650724879986,-74.04288411140442,9,3,12
W 233 St & Albany Crescent,40.87979,-73.90164,19,0,19
Nassau St & Duffield St,40.698477,-73.98384,41,8,49
Anthony Ave & E Tremont Ave,40.848793,-73.903178,5,12,17
72 St & Broadway,40.74751,-73.89372,10,11,21
53 St & 2 Ave,40.64744,-74.018846,23,5,28
W 129 St & Convent Ave,40.814394437915816,-73.95324736833572,21,8,29
Washington St & Barrow St,40.73191132323174,-74.008769094944,49,5,54
St Johns Pl & Kingston Ave,40.67113,-73.94222,11,3,14
W 49 St & 8 Ave,40.76227205,-73.98788205,14,52,66
Crotona Pkwy & Bronx Park S,40.84784,-73.883,9,11,20
Throop Ave & Myrtle Ave,40.69622937,-73.94371094,13,6,19
Liberty Light Rail,40.7112423,-74.0557013,19,0,19
Broadway & Whipple St,40.7016657,-73.9437303,14,11,25
1 Ave & E 30 St,40.74144387,-73.97536082,4,29,33
Delancey St & Eldridge St,40.719383,-73.991479,20,7,27
Devoe St & Morgan Ave,40.713811,-73.93515,8,9,17
Broadway & W 37 St,40.75172632,-73.98753523,8,49,57
46 St & 28 Ave,40.763328,-73.908782,11,6,17
Monroe St & Marcus Garvey Blvd,40.686722,-73.938988,8,7,15
Forsyth St & Broome St,40.71893904,-73.99266288,41,17,58
51 St & Hobart St,40.75767234025041,-73.90769943594933,9,13,22
Montgomery St & Franklin Ave,40.666439306870814,-73.9605563879013,18,1,19
Eastern Pkwy & Rochester Ave,40.66846,-73.9282,4,16,20
Van Sinderen Ave & Truxton St,40.6786,-73.90369,1,21,22
W 42 St & Dyer Ave,40.75898481399634,-73.99379968643188,14,17,31
Knickerbocker Ave & George St,40.704425,-73.92836,18,4,22
39 St & 50 Ave,40.73824937345944,-73.92737478017807,7,10,17
S 3 St & Bedford Ave,40.71260486,-73.96264403,11,13,24
Van Buren St & Broadway,40.692,-73.92617,10,11,21
47 Ave & 109 St,40.74713,-73.85502,17,10,27
46 St & 25 Ave,40.765753,-73.90676,8,12,20
Albany St & Greenwich St,40.709267,-74.013247,27,11,38
St Marks Ave & Rochester Ave,40.67404,-73.92772,6,14,20
Lenox Ave & W 111 St,40.7987859,-73.9523,0,0,0
Skillman Ave & Honeywell St,40.747148249032804,-73.92902433872223,7,11,18
Jackson Ave & 49 Ave,40.7429302,-73.952037,14,15,29
60 Pl & Flushing Ave,40.71988,-73.90556,11,6,17
Garrison Ave & Manida St,40.818743,-73.890247,13,10,23
31 St & Ditmars Blvd,40.776168,-73.910485,3,17,20
Knickerbocker Ave & Moffat St,40.690434,-73.903737,18,3,21
Grant Ave & MLK Dr,40.70919832245443,-74.08084273338318,15,2,17
W 15 St & 10 Ave,40.742753828659026,-74.00747358798981,45,8,53
2 Ave & 32 St,40.659176,-74.006584,21,3,24
74 St & 37 Ave,40.74908,-73.89172,0,28,28
McKibbin St & Bogart St,40.706237,-73.933871,27,2,29
Inwood Ave & W 170 St,40.840536,-73.919228,17,0,17
Jay St & Tech Pl,40.695065,-73.987167,11,39,50
Stephen St & Seneca Ave,40.6988,-73.9007,5,9,14
E 103 St & Lexington Ave,40.7903051,-73.94755757,25,6,31
5 Ave & 37 St,40.652657,-74.002356,24,1,25
Central Park W & W 103 St,40.79558954105342,-73.96188408136368,16,18,34
Grand Concourse & E 144 St,40.816576,-73.927987,12,10,22
Broadway & W 234 St,40.88185,-73.90291,26,0,26
E 165 St & Fox St,40.82394,-73.894025,15,11,26
Lenox Ave & W 144 St,40.819783,-73.936521,9,7,16
Lenox Ave & W 115 St,40.8011939,-73.9500739,23,1,24
E 174 St & Walton Ave,40.844811,-73.912042,9,16,25
98 St & 41 Ave,40.74773,-73.86649,10,8,18
Tiebout Ave & E 184 St,40.858498,-73.89637,6,9,15
MacDonough St & Marcy Ave,40.68078,-73.94613,16,0,16
Barry St & Tiffany St,40.816126,-73.891559,16,2,18
Parkside Ave & Ocean Ave,40.65485,-73.96217,22,0,22
56 Ave & Junction Blvd,40.73716,-73.86625,12,8,20
Jerome Ave & W 195 St,40.86874,-73.89657,10,20,30
Cauldwell Ave & E 161 St,40.82188,-73.907521,9,8,17
Caton Ave & St. Pauls Pl,40.65153,-73.96277,9,11,20
Kenmare St & Elizabeth St,40.72054,-73.9949,30,3,33
Court St & State St,40.6902375,-73.99203074,4,25,29
Ditmars Blvd & 48 St,40.769219,-73.901001,8,8,16
Union St & Bedford Ave,40.6691783,-73.9554162,1,18,19
Hazen St & 20 Ave,40.772092,-73.895166,19,2,21
Congress St & Hicks St,40.6893952,-73.9995126,29,1,30
103 St & 41 Ave,40.74875,-73.86285,19,2,21
Eastern Pkwy & Nostrand Ave,40.66967,-73.9503,7,19,26
Hancock St & Stuyvesant Ave,40.68454,-73.9322,16,0,16
40 St & 3 Ave,40.6535,-74.00902,24,5,29
72 St & Northern Blvd,40.75473,-73.89458,5,12,17
57 St & 37 Ave,40.75048,-73.90513,10,9,19
Main St & Plymouth St,40.703781673548306,-73.99073392152786,32,6,38
East End Ave & E 86 St,40.77518615,-73.94446054,14,11,25
Elmhurst Ave & Roosevelt Ave,40.74864,-73.87619,7,12,19
W 67 St & Broadway,40.77492513,-73.98266566,5,18,23
E 182 St & Park Ave,40.85455,-73.89507,21,0,21
Sedgwick Ave & W 195 St,40.87049,-73.90287,11,9,20
Willoughby Ave & Wyckoff Ave,40.705614,-73.92153,6,12,18
Broadway & W 138 St,40.82182,-73.95353,5,16,21
Mercer St & Spring St,40.72362738,-73.99949601,47,19,66
31 Ave & 86 St,40.75958,-73.88219,16,0,16
32 Ave & 77 St,40.75727,-73.89024,19,4,23
Eastern Pkwy & Franklin Ave (NE Corner),40.6707767,-73.9576801,1,29,30
W 113 St & Broadway,40.805973,-73.964928,9,21,30
W 47 St & 9 Ave,40.76153045158114,-73.99007007479668,25,19,44
Van Cortlandt Park S & Gouverneur Ave,40.88492,-73.89084,5,19,24
E 106 St & Lexington Ave,40.791976,-73.945993,24,2,26
Communipaw & Berry Lane,40.71435836870427,-74.06661093235016,12,0,12
E 170 St & Webster Ave,40.83617913677475,-73.90730146322765,6,11,17
Queens Blvd & 56 Ave,40.73481,-73.87431,32,2,34
Central Ave & Woodbine St,40.69296,-73.91605,11,4,15
E 118 St & Park Ave,40.8005385,-73.9419949,8,16,24
Ditmars Blvd & 43 St,40.771203,-73.903865,3,18,21
64 St & Woodbine St,40.70809,-73.89549,11,7,18
Court St & Nelson St,40.6763947,-73.99869893,28,0,28
Clinton St & Joralemon St,40.69239502,-73.99337909,23,16,39
Adelphi St & Myrtle Ave,40.69308257,-73.97178913,24,0,24
Rutgers St & Henry St,40.71332151208186,-73.99009689688683,35,2,37
E 115 St & Madison Ave,40.7989445,-73.944846,24,0,24
E 201 St & Briggs Ave,40.87207,-73.88459,13,1,14
Barrow St & Hudson St,40.73172428,-74.00674436,39,0,39
Prospect Park W & 20 St,40.656633,-73.983864,0,25,25
43 Ave & 42 St,40.74534682580983,-73.9219419658184,4,19,23
Metropolitan Ave & Stewart Ave,40.71401,-73.92793,16,2,18
Knickerbocker Ave & Thames St,40.70539,-73.92976,19,0,19
10 Ave & W 204 St,40.862638,-73.92006,10,6,16
Cathedral Pkwy & Broadway,40.804213,-73.96699104,15,2,17
Myrtle Ave & Grove St,40.69905,-73.91516,10,10,20
Dyckman St & Staff St,40.868846,-73.931537,13,5,18
5 Ave & E 72 St,40.77282817,-73.96685276,8,20,28
5 Ave & 44 St,40.64865,-74.00646,15,8,23
South Railroad Ave & Broadway,40.741,-73.88027,15,7,22
S 4 St & Rodney St,40.70934,-73.95608,10,7,17
34 Ave & 83 St,40.753935004830225,-73.88390148299196,12,7,19
W 190 St & Broadway,40.85648733523576,-73.93296986818314,8,13,21
Adam Clayton Powell Blvd & W 132 St,40.813539,-73.94521,12,8,20
76 St & 21 Ave,40.77028,-73.893675,17,3,20
Allen St & Rivington St,40.72019576,-73.98997825,16,18,34
Boston Rd & E 178 St,40.84096,-73.87923,17,6,23
Grove St PATH,40.71941,-74.04309,3,39,42
Brevoort Pl & Bedford Ave,40.68012,-73.95362,1,20,21
Union St & 4 Ave,40.6772744,-73.98282002,23,2,25
E 51 St & 1 Ave,40.75455731,-73.96592976,16,16,32
McKeever Pl & Sullivan Pl,40.66432331577469,-73.95921791486467,6,12,18
E 8 St & Caton Ave,40.648055,-73.972432,24,0,24
21 St & 20 Ave,40.78393602019729,-73.91273114065842,5,13,18
Dean St & Rockaway Ave,40.67486,-73.91123,16,5,21
Suydam St & St Nicholas Ave,40.70636,-73.91945,11,4,15
Borden Ave & 25 St,40.7396139,-73.945151,14,12,26
Grove St & Broadway,40.69047,-73.923511,15,14,29
Greenwich St & Perry St,40.73498,-74.00697,29,4,33
53 St & Roosevelt Ave,40.74462,-73.91143,3,13,16
W 181 St & Riverside Dr,40.85168,-73.94186,10,8,18
Bushwick Ave & Furman Ave,40.68281,-73.90623,12,16,28
Lafayette St & Jersey St,40.72456089,-73.99565293,14,37,51
53 Ave & 62 St,40.73169,-73.90159,19,0,19
54 St & 37 Ave,40.75098,-73.90799,12,12,24
Schenectady Ave & President St,40.66732,-73.93398,13,7,20
77 St & 24 Ave,40.76428,-73.89156,14,1,15
Columbus Ave & W 59 St,40.76931,-73.98464,2,36,38
Maple St & New York Ave,40.66104,-73.94795,22,0,22
Suydam St & Knickerbocker Ave,40.702013,-73.923769,21,5,26
Brooklyn Ave & Tilden Ave,40.64725,-73.94352,11,12,23
Lafayette Ave & Ft Greene Pl,40.68700231292619,-73.97664964199066,21,11,32
Central Ave & Covert St,40.68929,-73.90951,16,12,28
Steinway St & 21 Ave,40.774798,-73.903787,6,11,17
Bushwick Ave & Linden St,40.69146,-73.92146,24,2,26
64 St & 51 Ave,40.73577,-73.90184,17,0,17
E 102 St & 1 Ave,40.7869946,-73.94164802,13,4,17
Walnut Ave & E 136 St,40.801657,-73.909513,10,4,14
5 Ave & W 131 St,40.81014,-73.93973,11,9,20
State St & Smith St,40.68917,-73.9886,41,16,57
Albany Ave & Park Pl,40.67297,-73.93896,10,8,18
Bailey Ave & W 193 St,40.87069,-73.90678,18,0,18
River Ave & E 153 St,40.82441,-73.92818,21,1,22
Clinton St & 4 Place,40.6783563,-74.00014502,25,0,25
7 St & 3 Ave,40.67260298150126,-73.98983001708984,19,0,19
W Fordham Rd & Loring Pl N,40.86295,-73.90741,14,6,20
W 27 St & 6 Ave,40.74526,-73.99062,7,56,63
E 12 St & Ave C,40.727243,-73.976831,24,16,40
Amsterdam Ave & W 175 St,40.844044,-73.933651,5,13,18
6 Ave & 9 St,40.668127,-73.98377641,17,10,27
Clarkson Ave & E 37 St,40.65577,-73.9432,4,18,22
Corona Ave & 92 St,40.7424,-73.87251,17,0,17
E 26 St & 3 Ave,40.74069317733043,-73.98160636425018,17,20,37
3 Ave & E 82 St,40.775744,-73.9563752,36,4,40
Lorimer St & Broadway,40.70411791,-73.94818595,4,25,29
6 St & 7 Ave,40.6686627,-73.97988067,4,10,14
Tilden Ave & Lott St,40.64661,-73.95401,16,1,17
31 St & Astoria Blvd,40.7699176,-73.9184057,1,26,27
Frederick Douglass Blvd & W 139 St,40.81900581806558,-73.94476890563965,13,9,22
E 27 St & Park Ave S,40.74275179648995,-73.9847157150507,3,60,63
E 17 St & Beverley Rd,40.64466,-73.96322,20,0,20
Fulton St & Broadway,40.711066,-74.009447,10,36,46
3 St & Prospect Park West,40.668132,-73.97363831,1,29,30
Carmine St & 6 Ave,40.73038599,-74.00214988,31,30,61
W 35 St & Dyer Ave,40.754691750226016,-73.99740189313889,4,36,40
Metropolitan Ave & Bedford Ave,40.71534825,-73.96024116,18,32,50
Harman St & Seneca Ave,40.70577,-73.91292,7,9,16
Page Pl & Grand Ave,40.71798,-73.91818,16,3,19
Cadman Plaza E & Tillary St,40.69597683,-73.99014892,35,9,44
Madison St & Woodward Ave,40.70408,-73.90408,5,13,18
Frederick Douglass Blvd & Harlem River Dr,40.830702,-73.936371,13,2,15
Pacific St & Ralph Ave,40.67607,-73.92171,1,16,17
6 Ave & W 34 St,40.74964,-73.98805,37,26,63
Milton St & Franklin St,40.72906,-73.95779,20,8,28
Ave A & E 11 St,40.72854745023944,-73.98175925016403,43,16,59
W 90 St & Amsterdam Ave,40.79018,-73.97289,6,24,30
7 Ave & 20 St,40.659053,-73.98854,10,2,12
E 103 St & 2 Ave,40.78864,-73.9436,18,14,32
30 Ave & 12 St,40.771717105208275,-73.93159255385399,18,15,33
Catalpa Ave & Woodward Ave,40.70229,-73.90145,15,4,19
E 31 St & 3 Ave,40.74394314,-73.97966069,14,44,58
Broadway & Berry St,40.71036129922581,-73.96530389785767,31,3,34
Pearl St & Hanover Square,40.7047177,-74.00926027,27,36,63
2 Ave & E 99 St,40.7862586,-73.94552579,30,0,30
20 Ave & 48 St,40.772899,-73.896849,19,2,21
Bond St & Bergen St,40.6849668,-73.98620772,16,6,22
Stockholm St & Wilson Ave,40.699304,-73.923044,18,1,19
67 St & Erik Pl,40.633385,-74.016562,21,1,22
57 Rd & 58 St,40.72235,-73.91215,18,3,21
Carlton Ave & St Marks Ave,40.67911856082165,-73.97176265716553,10,12,22
Graham Ave & Withers St,40.7169811,-73.94485918,11,6,17
Jerome Ave & E Mosholu Pkwy S,40.87935,-73.88534,19,0,19
44 St & 48 Ave,40.73941387498411,-73.92131969332695,14,8,22
E 181 St & Bathgate Ave,40.85198,-73.89438,14,3,17
Martense Ave & 108 St,40.74214,-73.85418,8,9,17
Journal Square,40.73367,-74.0625,1,16,17
Adams St & Prospect St,40.700763083261506,-73.98869812488556,51,6,57
Eliot Ave & 60 Ln,40.71391,-73.90299,10,10,20
Tinton Ave & E 165 St,40.824796,-73.90242,3,12,15
24 Ave & 26 St,40.774591,-73.918544,12,6,18
Troy Ave & Linden Blvd,40.6533,-73.93644,21,1,22
W 171 St & St Nicholas Ave,40.842941,-73.938631,2,26,28
36 St & 47 Ave,40.742218349960964,-73.92935156822205,7,11,18
Pacific St & Troy Ave,40.67686,-73.93607,10,8,18
E 153 St & E 157 St,40.826677,-73.929327,5,12,17
W 87 St & Amsterdam Ave,40.78839,-73.9747,4,33,37
Clarkson Ave & Troy Ave,40.65633,-73.93648,17,6,23
31 St & Newtown Ave,40.7675487799971,-73.9209334552288,13,21,34
Engert Ave & McGuinness Blvd,40.72158,-73.94546,19,0,19
Driggs Ave & N 9 St,40.71816969454208,-73.95520135760307,31,17,48
48 St & Broadway,40.755763,-73.912715,3,26,29
W 10 St & Washington St,40.73342399437081,-74.00851495563984,57,0,57
57 St & 7 Ave,40.638566,-74.010147,5,11,16
8 Ave & W 24 St,40.74591072834279,-73.99807110428809,22,11,33
Monroe St & Tompkins Ave,40.686203,-73.944694,16,0,16
Union Ave & Jackson St,40.7160751,-73.952029,15,4,19
Front St & Gold St,40.70224,-73.982578,31,3,34
Crescent St & 30 Ave,40.768692,-73.9249574,12,11,23
19 St & 8 Ave,40.658489,-73.985543,2,20,22
102 St & 34 Ave,40.75584,-73.86621,3,15,18
W 180 St & Fort Washington Ave,40.849972,-73.938423,2,14,16
Columbia St & Lorraine St,40.6747055,-74.0075572,35,1,36
Brook Ave & E 141 St,40.809619,-73.917875,15,4,19
Grand Concourse & E 176 St,40.84761,-73.90745,6,16,22
Brooklyn Bridge Park - Pier 2,40.698458,-73.997178,7,16,23
West End Ave & W 94 St,40.7941654,-73.974124,20,3,23
E 19 St & 3 Ave,40.73624527,-73.98473765,13,22,35
Ditmars Blvd & 31 Dr,40.76138,-73.86035,22,4,26
Leonard St & Maujer St,40.7103685423523,-73.94705951213837,9,10,19
Fort Washington Ave & W 190 St,40.856906,-73.935662,2,16,18
E 163 St & Tiffany St,40.821075,-73.895069,15,3,18
Oakland Ave,40.7376037,-74.0524783,14,11,25
W 26 St & 10 Ave,40.749717753,-74.002950346,13,30,43
W 47 St & 6 Ave,40.758397,-73.98255,18,42,60
E 58 St & 1 Ave (NW Corner),40.759125,-73.962658,12,37,49
5 Ave & E 30 St,40.7459849,-73.98629487,11,44,55
Scholes St & Lorimer St,40.708323,-73.948732,9,12,21
100 St & Northern Blvd,40.75748,-73.86843,9,10,19
Amsterdam Ave & W 172 St,40.842173,-73.935111,7,6,13
Southern Blvd & Tiffany St,40.818185,-73.894143,15,0,15
47 Ave & 104 St,40.7458,-73.85945,17,3,20
Carroll St & Smith St,40.680611,-73.99475825,29,4,33
E 10 St & Ave A,40.72740794,-73.98142006,65,33,98
South End Ave & Albany St,40.709957,-74.016538,38,1,39
Dwight St & Dikeman St,40.67487503856169,-74.01048018571481,13,2,15
Montgomery St,40.71942,-74.05099,10,1,11
Douglass St & 4 Ave,40.6792788,-73.98154004,44,7,51
President St & Nostrand Ave,40.66811,-73.9505,4,20,24
FDR Drive & E 35 St,40.744219,-73.97121214,21,93,114
Hamilton Pl & W 140 St,40.822756,-73.951346,9,5,14
7 Ave & 22 St,40.658029,-73.989605,20,0,20
Sedgwick Ave & W Tremont Ave,40.85304455868985,-73.91830623149872,6,13,19
Convent Ave & W 151 St,40.82831,-73.942924,3,18,21
Grand Ave & 58 Ave,40.72098,-73.90701,18,1,19
E 158 St & Melrose Ave,40.822215,-73.914688,9,12,21
Jerome Ave & W 184 St,40.860814,-73.902541,15,3,18
39 Ave & 99 St,40.74962,-73.86677,2,19,21
Willis Ave & Bruckner Blvd,40.805701,-73.925177,3,15,18
Convent Ave & W 135 St,40.818215,-73.950988,5,24,29
Brooklyn Ave & Dean St,40.67669,-73.94437,13,5,18
30 Ave & 47 St,40.761294,-73.909562,4,15,19
Southern Blvd & E 187 St,40.8535,-73.88177,4,17,21
E 93 St & 2 Ave,40.782454175279874,-73.9489196240902,68,0,68
Monmouth & 6th,40.72568548362901,-74.04879033565521,3,11,14
Church Sq Park - 5 St & Park Ave,40.74265933273143,-74.03223305940628,2,16,18
Adams St & 2 St,40.73981372311843,-74.03690412640572,9,5,14
Sterling Pl & Bedford Ave,40.672695,-73.954131,11,11,22
3 Ave & 14 St,40.6685455,-73.99333264,22,3,25
Broadway & 12 St,40.7668,-73.9347774,17,13,30
9 Ave & W 204 St,40.86169883507865,-73.91855701804161,20,2,22
Elmhurst Ave & Forley St,40.74615,-73.87763,5,16,21
Corona Ave & 90 St,40.74154,-73.87484,13,8,21
99 St & 58 Ave,40.73761,-73.85959,13,12,25
9 Ave & W 18 St,40.74317449,-74.00366443,74,2,76
Pacific St & Rochester Ave,40.67639,-73.92748,7,8,15
23 Rd & 31 St,40.77336750284339,-73.91382560133934,8,9,17
Kosciuszko St & Nostrand Ave,40.69072549,-73.95133465,11,10,21
North Moore St & Greenwich St,40.72019521437465,-74.0103006362915,7,18,25
N 11 St & Kent Ave,40.72248188638219,-73.95921930670738,9,16,25
Townsend Ave & E 175 St,40.84741,-73.911359,14,1,15
Lorimer St & Harrison Ave,40.702726,-73.94984,13,5,18
W 44 St & 11 Ave,40.762009,-73.996975,39,34,73
Nelson Ave & 167 St,40.83670566862804,-73.92608866095543,9,7,16
Bedford Ave & Clarkson Ave,40.65519,-73.9564,12,1,13
Railroad Ave & Kay Ave,40.70514807698391,-73.97078096866608,19,11,30
N Portland Ave & Flushing Ave,40.697926,-73.97663,14,17,31
47 St & 3 Ave,40.649143,-74.012384,20,2,22
E 13 St & 2 Ave,40.73153937464073,-73.9853024482727,14,31,45
91 St & 31 Ave,40.76022,-73.87774,19,2,21
Cypress Ave & Palmetto St,40.701573408737914,-73.90876293182373,2,22,24
E 167 St & Franklin Ave,40.82895,-73.90521,2,12,14
Lafayette Ave & Franklin Ave,40.689271,-73.957324,11,16,27
Tibbett Ave & W 234 St,40.88324,-73.90587,19,0,19
31 Ave & 103 St,40.76134,-73.86666,4,16,20
61 St & Woodside Ave,40.74501,-73.9036,2,15,17
E 58 St & 3 Ave,40.76095756,-73.96724467,9,39,48
6 Ave & 12 St,40.6663181,-73.9854617,28,0,28
Eldert St & Bushwick Ave,40.68652,-73.91321,12,8,20
W 95 St & Broadway,40.7937704,-73.971888,0,26,26
W 37 St & Broadway,40.75227093837409,-73.98770570755005,7,73,80
12 St & 4 Ave,40.668603,-73.9904394,21,2,23
Central Park S & Grand Army Plaza,40.764555,-73.973473,1,83,84
Lewis Ave & Kosciuszko St,40.69237074,-73.93705428,13,10,23
Morris Canal,40.7124188237569,-74.03852552175522,7,5,12
51 St & Queens Blvd,40.7429,-73.91395,1,17,18
E 91 St & 2 Ave,40.781152764279156,-73.94963040947914,70,0,70
51 Ave & 61 St,40.73568,-73.90387,16,2,18
Wilkins Ave & Crotona Park E,40.835302,-73.895133,3,13,16
65 St & Roosevelt Ave,40.74589,-73.89915,10,18,28
Riverside Dr E & W 155 St,40.834097985815255,-73.94834974194816,12,7,19
Henry St & Middagh St,40.7003,-73.991581,18,17,35
E 50 St & Park Ave,40.757334,-73.974235,1,35,36
Crescent St & Ditmars Blvd,40.7787185,-73.9145645,3,13,16
Thompson St & Bleecker St,40.72840059450829,-73.99968780577183,51,7,58
Banker St & Meserole Ave,40.72606,-73.95621,17,11,28
51 St & 43 Ave,40.74451,-73.91412,1,25,26
Sterling Pl & 5 Ave,40.678970070475735,-73.97855266928671,17,3,20
Pioneer St & Richards St,40.6777748,-74.0094613,19,2,21
Turner Pl & Coney Island Ave,40.64521,-73.97073,19,0,19
Concord St & Bridge St,40.69766564,-73.98476437,1,13,14
Greenwood Ave & E 4 St,40.650739,-73.977739,8,12,20
Greenwich St & Hubert St,40.721319,-74.010065,7,23,30
34 Ave & 48 St,40.75388,-73.914952,4,17,21
N 6 St & Bedford Ave,40.71745169,-73.95850939,0,21,21
Stewart Ave & Johnson Ave,40.70869,-73.92587,8,7,15
Crown St & Troy Ave,40.66559,-73.93712,3,16,19
E 80 St & 2 Ave,40.77391390238118,-73.9543953537941,13,19,32
Bushwick Ave & McKibbin St,40.705517,-73.93936,12,8,20
Ditmars Blvd & 76 St,40.768442,-73.893531,10,7,17
Pitkin Ave & Grafton St,40.66852,-73.91908,0,21,21
56 Dr & 59 St,40.72403,-73.90853,14,5,19
Sterling Pl & Franklin Ave,40.67324785,-73.95689517,13,4,17
46 Ave & 5 St,40.74731,-73.95451,27,14,41
30 Ave & 96 St,40.76086,-73.87308,17,2,19
Stagg St & Morgan Ave,40.710681,-73.93372,18,4,22
60 Ave & Fresh Pond Rd,40.71693,-73.90198,10,8,18
Greene Ave & Nostrand Ave,40.6883337,-73.950916,7,6,13
Woodside Ave & 69 St,40.7428,-73.89584,2,15,17
Southpoint Park,40.75370225419114,-73.95865201950072,29,4,33
49 Ave & 108 St,40.74535,-73.8558,16,3,19
W 29 St & 9 Ave,40.7500727,-73.99839279,17,23,40
W 52 St & 6 Ave,40.76132983124814,-73.97982001304626,1,53,54
Lewis Ave & Madison St,40.686312,-73.935775,12,9,21
Hoboken Ave at Monmouth St,40.73520838045357,-74.04696375131607,20,12,32
Taylor St & Bedford Ave,40.705774,-73.963252,23,0,23
Hamilton Park,40.727595966,-74.044247311,16,8,24
Willis Ave & E 141 St,40.81093,-73.921606,11,4,15
E 81 St & Park Ave,40.77677702,-73.9590097,15,26,41
Whitney Ave & Ketcham Pl,40.74249,-73.87809,11,11,22
10 Ave & W 14 St,40.741981599940225,-74.00831580162048,69,3,72
W 144 St & Adam Clayton Powell Blvd,40.820877,-73.939249,7,15,22
E 9 St & 5 Ave,40.73275887045087,-73.99581670761108,35,18,53
Echo Pl & Grand Concourse,40.849955,-73.905943,14,12,26
Vesey St & Church St,40.71221958009051,-74.01047229766846,21,51,72
E 191 St & Bathgate Ave,40.8601,-73.8866,26,3,29
Amsterdam Ave & W 82 St,40.78524672,-73.97667321,10,25,35
Lenox Ave & W 117 St,40.8025566,-73.9490782,9,16,25
Ashland Pl & Dekalb Ave,40.690065,-73.978776,31,13,44
10 Ave & W 207 St,40.864632,-73.918598,18,19,37
Willoughby Ave & Tompkins Ave,40.69425403,-73.94626915,18,0,18
Sterling Pl & Rochester Ave,40.67128,-73.92825,9,12,21
Vesey St & Greenwich St,40.71254669463547,-74.01113051087516,24,82,106
Davis St & Jackson Ave,40.745627,-73.945661,8,25,33
Old Slip & South St,40.70336686695866,-74.007867872715,80,10,90
Beverley Rd & Nostrand Ave,40.64507,-73.9488,20,0,20
E 84 St & 1 Ave,40.77565541,-73.95068615,21,7,28
Bedford Ave & Albemarle Rd,40.64796,-73.9556,15,0,15
W 165 St & Fort Washington Ave,40.84004,-73.942939,1,24,25
11 Ave & W 59 St,40.77149671054441,-73.99046033620834,17,3,20
Broadway & W 25 St,40.74286877312112,-73.98918628692627,1,105,106
Hilltop,40.7311689,-74.0575736,18,6,24
E 115 St & Lexington Ave,40.797911,-73.9423,15,3,18
E 88 St & 1 Ave,40.778301,-73.9488134,30,2,32
55 St & Northern Blvd,40.75326,-73.90585,11,11,22
Sunken Meadow Comfort Station,40.79558,-73.91906,4,20,24
29 St & Skillman Ave,40.744831,-73.938411,12,14,26
Metropolitan Ave & Meeker Ave,40.71413311,-73.95234386,9,16,25
Manhattan Ave & Leonard St,40.72084,-73.94844,17,1,18
6 Ave & 60 St,40.638196,-74.013821,17,2,19
Crotona Park North & Prospect Ave,40.841092,-73.892317,2,17,19
11 Ave & W 27 St,40.751396,-74.005226,24,16,40
South St & Broad St,40.70188858913366,-74.01089876890182,14,17,31
W 192 St & University Ave,40.866899,-73.901942,8,12,20
114 St & 39 Ave,40.7532,-73.853,29,0,29
Buffalo Ave & St John's Pl,40.67015,-73.92538,5,16,21
Carroll St & Columbia St,40.6830456,-74.00348559,38,0,38
W 11 St & 6 Ave,40.73532427,-73.99800419,47,24,71
Dyckman St & 10 Ave,40.85890447538412,-73.9230939745903,9,7,16
Lexington Ave & E 128 St,40.806414,-73.936085,18,3,21
Maurice Ave & 53 Dr,40.73028,-73.90421,15,0,15
Steinway St & 19 Ave,40.778089,-73.899558,15,4,19
DeKalb Ave & Vanderbilt Ave,40.68940747,-73.96885458,3,14,17
16 St & 4 Ave,40.666197,-73.992466,27,0,27
Division Ave & Hooper St,40.70684203101325,-73.9544353965357,28,27,55
N 10 St & Berry St,40.720253,-73.957082,29,14,43
McDonald Ave & Vanderbilt St,40.651654,-73.981231,16,4,20
E 180 St & Prospect Ave,40.84696,-73.88663,8,14,22
Frederick Douglass Blvd & W 112 St,40.801694,-73.957145,25,5,30
21 Ave & Crescent St,40.780478,-73.912212,9,7,16
Canal St & Rutgers St,40.71427487,-73.98990025,36,4,40
E 116 St & 2 Ave,40.796879,-73.937261,25,5,30
University Pl & E 8 St,40.73143724085228,-73.99490341544151,16,45,61
Bainbridge Ave & E 196 St,40.86648,-73.89042,12,6,18
Cooper Ave & 65 Pl,40.69953,-73.88873,9,13,22
Wadsworth Ave & W 179 St,40.848467,-73.936064,2,30,32
Glenwood Ave,40.72755146730012,-74.07106071710587,14,2,16
50 St & 30 Ave,40.760083,-73.907107,8,13,21
34 St & 4 Ave,40.655278,-74.003101,18,3,21
74 St & Woodside Ave,40.74325,-73.89079,5,12,17
St Felix Ave & 61 St,40.69715,-73.8936,3,14,17
2 Ave & E 125 St,40.802554,-73.933509,21,3,24
Pier 40 - Hudson River Park,40.7277140777778,-74.01129573583603,9,4,13
60 Pl & Bleecker St,40.71107,-73.903,3,13,16
47 Ave & Skillman Ave,40.7437524099784,-73.94176483154297,12,7,19
Columbus Ave & W 72 St,40.7770575,-73.97898475,18,45,63
E 138 St & Willow Ave,40.804168,-73.911545,17,1,18
Dean St & Franklin Ave,40.67759206937376,-73.955637216568,17,1,18
E 149 St & Morris Ave,40.81734,-73.922962,11,19,30
58 St & 32 Ave,40.75574,-73.903427,5,12,17
