Name,Latitude,Longitude,Free Bikes,Empty Slots,Total Bikes
Chester Ave & 12 Ave,40.644367,-73.984276,7,14,21
W 56 St & 8 Ave,40.765959181657976,-73.98313522338867,0,49,49
S Portland Ave & Hanson Pl,40.68539567,-73.97431458,8,18,26
E 78 St & 2 Ave,40.7727966,-73.95577801,11,10,21
87 St & Roosevelt Ave,40.74825,-73.87936,4,19,23
E 157 St & River Ave,40.825737,-73.927311,12,5,17
E 17 St & Broadway,40.737006,-73.990134,5,71,76
Central Ave & Flushing Ave,40.702831,-73.9333,16,2,18
E 149 St & Eagle Ave,40.814046,-73.91186,3,16,19
E 165 St & Jerome Ave,40.83263,-73.925101,15,2,17
72 St & 31 Ave,40.7584,-73.89531,12,6,18
Irwin Ave & W 232 St,40.88227,-73.90809,11,4,15
Nassau Ave & Russell St,40.72557,-73.94434,32,19,51
1 St & 6 Ave,40.672784,-73.979826,18,16,34
Bulova Ave & Brooklyn Queens Expressway W,40.762507,-73.902534,7,8,15
45 St & 4 Ave,40.649145,-74.009486,7,13,20
Watts St & Greenwich St,40.72405549,-74.00965965,33,1,34
Broadway & E 14 St,40.73454567,-73.99074142,20,91,111
Harrison Pl & Porter Ave,40.70686,-73.92851,15,4,19
W 87 St & West End Ave,40.789622,-73.97757,0,44,44
3 Ave & E 109 St,40.79338,-73.94329,18,7,25
Myrtle Ave & St Edwards St,40.69327018,-73.97703874,47,6,53
E 9 St & Ave C,40.72521311,-73.97768752,21,25,46
Marcy Ave & Gates Ave,40.686679,-73.947417,4,17,21
Beverley Rd & Flatbush Ave,40.64499,-73.95818,20,6,26
Bergen St & Vanderbilt Ave,40.6794388,-73.9680438,16,1,17
E 149 St & Park Ave,40.818154,-73.925294,9,15,24
Sheridan Ave & E 168 St,40.835334,-73.9154,2,16,18
Dyckman St & Henshaw St,40.867357,-73.92936,16,2,18
Hudson St & Reade St,40.71625008,-74.0091059,19,34,53
E 106 St & 1 Ave,40.7892529,-73.93956237,12,13,25
E 1 St & Bowery,40.72486122254819,-73.99213135242462,39,0,39
DeKalb Ave & Franklin Ave,40.69064807082943,-73.95746178925037,5,7,12
Melrose Ave & E 150 St,40.816827,-73.917338,17,13,30
Botanical Sq & Webster Ave,40.86814,-73.88145,28,1,29
E 23 St & 1 Ave,40.736502,-73.97809472,3,21,24
Buchanan Pl & Grand Ave,40.85834,-73.90626,9,10,19
Flatbush Ave & Ocean Ave,40.663657,-73.963014,30,1,31
Halsey St & Evergreen Ave,40.68858,-73.91227,6,15,21
Southern Blvd & E 174 St,40.836733,-73.887931,7,18,25
Park Pl & Church St,40.71334184275907,-74.00935515761375,22,29,51
Kent Ave & N 7 St,40.72036775298455,-73.96165072917938,51,2,53
E 188 St & Creston Ave,40.861669,-73.898589,8,22,30
63 St & 59 Dr,40.71832,-73.90128,22,0,22
Decatur Ave & E 197 St,40.86557,-73.88807,18,0,18
E 94 St & Madison Ave,40.785851052913884,-73.95482444378061,37,0,37
55 Ave & 90 St,40.73676,-73.87318,7,10,17
Vernon Blvd & 41 Rd,40.7552433,-73.9485678,5,22,27
South St & Whitehall St,40.70122128,-74.01234218,42,6,48
21 St & Queens Plaza North,40.75325964,-73.94335788,9,25,34
Bronx Park S & Bryant Ave,40.84437,-73.87796,16,2,18
E 34 St & Linden Blvd,40.65302,-73.94599,6,16,22
Liberty St & Broadway,40.70905623,-74.01043382,16,45,61
Frost St & Debevoise Ave,40.71882,-73.93948,12,9,21
3 Ave & Schermerhorn St,40.68683208,-73.9796772,12,22,34
Franklin Ave & St Marks Ave,40.6758324,-73.9561677,6,22,28
W 170 St & University Ave,40.84207,-73.926075,8,12,20
Menahan St & Wyckoff Ave,40.70113,-73.91422,8,11,19
E 114 St & 1 Ave,40.7945663,-73.9362541,15,8,23
Ave D & E 3 St,40.72082834,-73.97793172,5,42,47
Edgecombe Ave & W 167 St,40.838191,-73.936085,10,8,18
W 100 St & Broadway,40.7973721,-73.97041192,7,26,33
Caton Ave & E 10 St,40.648481,-73.97058,19,7,26
Morningside Ave & W 123 St,40.81,-73.9551508,11,20,31
Gerard Ave & E 164 St,40.830262,-73.923391,3,12,15
Eastern Pkwy & Brooklyn Ave,40.66939,-73.94514,10,8,18
Riverview Park,40.7443187,-74.0439909,7,9,16
W 42 St & 6 Ave,40.75492,-73.98455,24,27,51
Riverside Dr & W 138 St,40.823168,-73.955857,9,18,27
39 St & Queens Blvd,40.74431,-73.92601,3,18,21
95 St & 35 Ave,40.75301,-73.87266,2,20,22
W 78 St & Broadway,40.78339981,-73.98093133,7,31,38
Coffey St & Conover St,40.677236,-74.015665,27,0,27
Warren St & Smith St,40.685424009970184,-73.99127773940563,19,5,24
E 91 St & Park Ave,40.7835016,-73.955327,21,2,23
59 St & 4 Ave,40.641269,-74.017651,27,0,27
5 Ave & W 126 St,40.80722,-73.9418,16,11,27
W 15 St & 6 Ave,40.738046142482766,-73.99642959237099,19,55,74
Crotona Pkwy & Elsmere Pl,40.84188,-73.8855,7,17,24
Powers St & Olive St,40.71323,-73.93894,4,15,19
E 55 St & 2 Ave,40.75797322,-73.96603308,2,22,24
Morris Ave & E 142 St,40.814469,-73.924963,4,16,20
Case St & 94 St,40.74619,-73.87193,2,18,20
E 2 St & Ave B,40.72217444,-73.98368779,40,40,80
Fulton Ave & E 168 St,40.830471,-73.904556,16,4,20
W 92 St & Broadway,40.7921,-73.9739,1,18,19
36 St & 4 Ave,40.654144,-74.00422,19,7,26
Bloomfield St & 15 St,40.75453,-74.02658,0,13,13
Broadway & W 153 St,40.831327,-73.946665,0,16,16
E 17 St & 2 Ave,40.73431166276575,-73.98372530937195,2,43,45
Forley St & Lamont Ave,40.74463,-73.87386,9,9,18
Market St & Henry St,40.71310702305908,-73.99446353316307,33,1,34
Pacific St & Smith St,40.687880939612775,-73.98939281702042,43,4,47
Pacific St & Classon Ave,40.6791944,-73.9587903,1,16,17
Montague St & Hicks St,40.69522407512035,-73.99598850939152,4,26,30
W 56 St & 10 Ave,40.768254,-73.988639,6,36,42
Grand Concourse & E 199 St,40.87142,-73.88839,13,7,20
Knickerbocker Ave & Halsey St,40.693,-73.90824,3,16,19
Seneca Ave & Irvine St,40.81885,-73.88821,11,6,17
New York Ave & Snyder Ave,40.64868,-73.94635,17,3,20
111 St & 49 Ave,40.74612,-73.85272,23,6,29
Home St & Westchester Ave,40.827629,-73.886659,18,1,19
Andrews Ave S & W 179 St,40.855156,-73.91278,2,17,19
Lott St & Erasmus St,40.64949,-73.95408,7,12,19
Putnam Ave & Throop Ave,40.6851532,-73.94111,4,14,18
21 St & Hoyt Ave S,40.774645,-73.923706,25,6,31
E 176 St & Clinton Ave,40.84311,-73.89149,9,9,18
39 Dr & 52 St,40.74732,-73.91197,2,15,17
Jay St & York St,40.701403172577244,-73.98672670125961,25,6,31
Greenpoint Ave & 47 St,40.7424,-73.91808,2,22,24
Clinton St & Centre St,40.67434,-74.00194698,15,6,21
Bedford Ave & Fenimore St,40.65815,-73.95674,9,10,19
E 179 St & Southern Blvd,40.84467,-73.88507,15,9,24
E 134 St & Walnut Ave,40.800425,-73.911034,12,3,15
Freeman St & Reverend James A Polite Ave,40.830529,-73.894717,12,7,19
Carroll St & Washington Ave,40.6686744,-73.9618148,18,0,18
W 45 St & 8 Ave,40.75929124,-73.98859651,62,0,62
Bergen St & Saratoga Ave,40.67423,-73.91656,3,14,17
Cleveland Pl & Spring St,40.722103786686034,-73.99724900722504,23,4,27
E 180 St & Monterey Ave,40.85025,-73.89301,8,7,15
Sumpter St & Fulton St,40.67923,-73.92588,5,14,19
79 St & Woodside Ave,40.74364,-73.88622,7,11,18
E 15 St & 3 Ave,40.734232,-73.986923,17,58,75
Woodside Ave & 55 St,40.74679,-73.90893,1,14,15
Nostrand Ave & Flushing Ave,40.69928,-73.953259,19,5,24
20 Ave & 31 St,40.78001336610564,-73.90667617321014,6,15,21
Franklin St & Dupont St,40.73564,-73.95866,18,10,28
Myrtle Ave & Lewis Ave,40.69681963,-73.93756926,1,17,18
1 Ave & E 94 St,40.7817212,-73.94594,30,8,38
E 135 St & St Ann's Ave,40.805089,-73.918889,21,0,21
E 35 St & Madison Ave,40.74848023448579,-73.98255586624146,9,38,47
49 St & 25 Ave,40.764496,-73.904632,9,15,24
Strong St & University Ave,40.87119,-73.89918,2,15,17
Carlton Ave & Park Ave,40.69580705,-73.97355569,3,17,20
Clinton St & Tillary St,40.696232971293156,-73.99142056703568,6,25,31
Sheridan Ave & E 172 St,40.840494,-73.911479,10,12,22
19 St & 24 Ave,40.7774552,-73.9225403,19,4,23
Winthrop St & Schenectady Ave,40.6582,-73.9338,13,6,19
Forsyth St & Canal St,40.7158155,-73.99422366,27,0,27
6 Ave & 21 St,40.66016,-73.990974,2,17,19
100 St & 37 Ave,40.75243,-73.86717,9,9,18
Beaver St & Fayette St,40.70099,-73.93921,22,6,28
Malcolm X Blvd & DeKalb Ave,40.6938,-73.93114,0,18,18
Walton Ave & E 183 St,40.858472,-73.90266,9,16,25
Somers St & Rockaway Ave,40.67872,-73.91105,5,16,21
Carroll St & 5 Ave,40.6751622,-73.9814832,22,2,24
Astor Place,40.71928220070702,-74.07126188278198,3,11,14
12 St & Sinatra Dr N,40.750604142368964,-74.02402013540268,23,2,25
Cedar St & Myrtle Ave,40.697842,-73.926241,3,21,24
E 45 St & 3 Ave,40.75255434,-73.97282625,7,25,32
Morris Ave & McClellan St,40.831584,-73.9149,15,4,19
E 161 St & River Ave,40.827883,-73.927111,35,2,37
Park Ave & Marcy Ave,40.697576,-73.948881,8,15,23
81 St & 35 Ave,40.75179,-73.88568,0,21,21
3 Ave & E 189 St,40.85985,-73.89135,28,1,29
27 Ave & 3 St,40.77485,-73.9342,5,10,15
Decatur Ave & Bedford Park Blvd,40.86813,-73.88412,18,2,20
Riverside Dr & W 82 St,40.78720869,-73.98128127,11,61,72
Fulton St & Adams St,40.692418292578466,-73.98949474096298,15,29,44
32 Ave & 81 St,40.75763,-73.88682,5,13,18
Driggs Ave & S 2 St,40.712628,-73.960575,6,24,30
Jerome Ave & W 193 St,40.86659,-73.89794,8,7,15
W 74 St & Columbus Ave,40.7785669,-73.97754961,7,14,21
Central Ave & Himrod St,40.69676,-73.92302,3,18,21
W 17 St & 8 Ave,40.74177603,-74.00149746,35,37,72
Paul Ave & W 205 St,40.87704,-73.88943,15,4,19
Ditmars Blvd & 79 St,40.768728,-73.890745,23,2,25
3 Ave & E 174 St,40.84224,-73.8985,28,4,32
Broadway & 49 St,40.755389,-73.911517,8,15,23
Calyer St & Jewel St,40.72984,-73.94839,32,8,40
Cypress Hills St & Otto Rd,40.70204,-73.89288,14,4,18
61 St & 39 Ave,40.7471,-73.9028,27,1,28
E 179 St & Daly Ave,40.84335,-73.88247,8,11,19
Concourse Village West & E 156 St,40.823162,-73.923267,1,14,15
Grand St,40.71517767732029,-74.03768330812454,11,6,17
Perry St & Bleecker St,40.73535398,-74.00483091,60,6,66
Broadway & Battery Pl,40.70463334,-74.01361706,29,18,47
Waldron St & 108 St,40.73916,-73.8526,17,1,18
Prospect Pl & Underhill Ave,40.6769694,-73.96579,15,7,22
Broadway & Moylan Pl,40.8143256,-73.9590255,35,6,41
Queens Blvd & 56 St,40.74193,-73.90913,16,2,18
1 Ave & E 42 St,40.7487575,-73.970127,18,40,58
Amsterdam Ave & W 189 St,40.85318758861975,-73.92715752124786,7,12,19
Buffalo Ave & E New York Ave,40.66591,-73.92602,19,3,22
E 182 St & Grand Concourse,40.85591,-73.90051,0,25,25
Prospect Ave & E 151 St,40.814232,-73.903927,2,17,19
5 Ave & 67 St,40.635679,-74.020005,16,3,19
34 Ave & 74 St,40.75297,-73.89236,17,7,24
E 2 St & Ave C,40.7208736,-73.98085795,24,51,75
Sands St & Jay St,40.700119,-73.9862,38,0,38
Fulton Ave & E 172 St,40.839229,-73.899047,2,16,18
Christ Hospital,40.734785818,-74.050443636,7,15,22
112 St & Northern Blvd,40.75788,-73.85763,14,6,20
59 St & 5 Ave,40.640125,-74.015726,20,7,27
Irving Ave & Palmetto St,40.698,-73.9127,5,13,18
University Ave & Macombs Rd,40.8496401,-73.9161206,0,23,23
W 76 St & Columbus Ave,40.7801839724239,-73.97728532552719,24,17,41
Devoe St & Lorimer St,40.71335226222875,-73.9491033554077,11,8,19
Lewis Ave & Fulton St,40.67972,-73.93467,12,4,16
E 43 St & 2 Ave,40.75022392,-73.97121414,2,45,47
Cortelyou Rd & E 34 St,40.64454,-73.94486,15,3,18
46 St & Queens Blvd,40.74349759836971,-73.91860529780388,4,27,31
Picnic Point,40.68512559515415,-74.02535319328308,14,29,43
26 Ave & 2 St,40.77684387,-73.93463418,12,8,20
Goulden Ave & W 205 St,40.87812,-73.89192,3,14,17
53 Ave & 94 St,40.73921,-73.86887,10,8,18
Tilden Ave & Nostrand Ave,40.64683,-73.94933,16,4,20
62 St & 43 Ave,40.74261,-73.903,8,10,18
E 7 St & Ave B,40.7251285241158,-73.98131668567657,21,47,68
99 St & 35 Ave,40.75404,-73.86887,4,18,22
2 Ave & E 29 St,40.741723510974715,-73.97809267044067,1,52,53
E 6 St & 2 Ave,40.727378693232225,-73.98840844631195,26,36,62
21 St & 21 Ave,40.782465,-73.914527,1,15,16
Soissons Landing,40.69231660719192,-74.01486575603485,10,17,27
Schermerhorn St & Court St,40.6910363748993,-73.99201065301895,43,13,56
W 89 St & Columbus Ave,40.7882213,-73.97041561,2,45,47
44 Dr & 21 St,40.748036,-73.946705,29,10,39
Little West St & 1 Pl,40.70569254,-74.01677685,25,2,27
E 66 St & Madison Ave,40.76800889305947,-73.96845281124115,12,21,33
108 St & 39 Ave,40.75165,-73.85915,9,12,21
35 St & Broadway,40.760339,-73.9222427,4,9,13
44 Dr & Jackson Ave,40.74718234,-73.9432635,7,24,31
2 Ave & 37 St,40.65624,-74.00933,43,1,44
Front St & Jay St,40.702461,-73.986842,20,4,24
E 10 St & 5 Ave,40.73331967,-73.99510132,25,19,44
51 Ave & Junction Blvd,40.74087,-73.86772,11,4,15
Halsey St & Broadway,40.68565,-73.91564,14,5,19
Southern Blvd & E 175 St,40.839335,-73.886445,9,7,16
Berkeley Pl & 6 Ave,40.6765304,-73.97846879,29,11,40
Linden Blvd & Nostrand Ave,40.65272,-73.94994,9,10,19
Broadway & Roebling St,40.70924826276157,-73.96063148975372,8,18,26
92 St & Astoria Blvd,40.76313,-73.8772,16,1,17
Charlotte St & Boston Rd,40.8358771,-73.8931428,4,12,16
W 18 St & 9 Ave,40.7435337324616,-74.00367558002472,35,0,35
Brook Ave & E 138 St,40.807408,-73.91924,16,3,19
Grand Concourse & E 171 St,40.839549,-73.913004,3,19,22
Ralph Ave & Fulton St,40.67922,-73.92192,17,8,25
Broadway & W 157 St,40.83402740143528,-73.94510813442648,16,9,25
Leonard St & Church St,40.717571,-74.005549,18,30,48
56 St & 2 Ave,40.645705,-74.020292,32,3,35
Bedford Ave & Bergen St,40.676368,-73.952918,3,16,19
Bus Slip & State St,40.701907,-74.013942,53,10,63
Greene Ave & Grandview Ave,40.709697,-73.907856,1,13,14
JC Medical Center,40.71539114317,-74.04969155788422,18,0,18
Church Ave & E 45 St,40.65159,-73.93535,8,15,23
Fulton St & William St,40.70960089363537,-74.00655090808868,4,39,43
Hoboken Terminal - River St & Hudson Pl,40.7360676564825,-74.02912706136703,23,21,44
E 81 St & York Ave,40.7728384,-73.94989233,1,43,44
69 St & 43 Ave,40.74179,-73.89564,3,15,18
W 25 St & 8 Ave,40.74649996333341,-73.99732626293645,4,57,61
Park Circle & East Dr,40.651566,-73.972212,25,2,27
50 St & 7 Ave,40.642501,-74.006055,0,21,21
Degraw St & Hoyt St,40.681990442707026,-73.99079024791718,17,3,20
E Fordham Rd & Webster Ave,40.861748,-73.89105,30,0,30
Ave D & E 10 St,40.72506551015475,-73.97515833377838,3,22,25
36 St & Queens Blvd,40.74408,-73.92901,9,13,22
Flatbush Ave & Lincoln Rd,40.66131,-73.96091,16,0,16
E 174 St & Longfellow Ave,40.836274,-73.884308,16,1,17
Wilson Ave & Moffat St,40.68906,-73.90506,3,26,29
E 156 St & Brook Ave,40.819823,-73.912411,3,12,15
8 Ave & W 33 St,40.751551,-73.993934,49,43,92
Pleasant Ave & E 120 St,40.7974772,-73.9311847,13,2,15
Onderdonk Ave & Gates Ave,40.70413,-73.90737,1,18,19
Prospect Pl & 6 Ave,40.6793307,-73.97519523,10,11,21
University Ave & Brandt Pl,40.848354,-73.918389,3,17,20
Lincoln Ave & E 138 St,40.810893,-73.927311,8,12,20
Edgecombe Ave & W 141 St,40.820681,-73.945144,2,16,18
8 Ave & W 27 St,40.747968,-73.996637,2,21,23
W 20 St & 5 Ave,40.73972989238724,-73.99103969335556,13,39,52
Lenox Ave & W 146 St,40.821111,-73.935971,4,19,23
Prospect Park SW & 10 Ave,40.659945,-73.977504,4,21,25
Boone Ave & E 172 St,40.832649,-73.885272,7,8,15
Ave D & E 12 St,40.72580614,-73.97422494,2,36,38
81 St & 34 Ave,40.75374,-73.88604,0,23,23
Marshall St & 2 St,40.740802,-74.042521,3,13,16
West End Ave & W 60 St,40.77237,-73.99005,6,25,31
46 St & 30 Rd,40.76072,-73.910989,6,12,18
Bayard St & Leonard St,40.71915571696044,-73.94885390996933,27,16,43
31 Ave & 30 St,40.7647,-73.9240312,0,19,19
49 Ave & 27 St,40.74113,-73.942518,14,10,24
14 St Ferry - 14 St & Shipyard Ln,40.752960630464955,-74.02435272932053,26,2,28
43 St & 35 Ave,40.754139,-73.919543,1,24,25
Richards St & Delavan St,40.6794327,-74.00785041,15,0,15
Park Pl & Buffalo Ave,40.67202,-73.92539,7,12,19
E 61 St & Madison Ave,40.764752828526326,-73.97037800510203,13,20,33
E 89 St & 3 Ave,40.7806284,-73.9521667,14,17,31
Grand Concourse & E 181 St,40.85466,-73.9015,9,13,22
56 Dr & 61 St,40.72368,-73.90458,13,3,16
Lexington Ave & E 29 St,40.74311555376486,-73.98215353488922,3,51,54
Ogden Ave & W 165 St,40.834457,-73.928381,2,17,19
Willoughby Ave & Hall St,40.69196035,-73.96536851,5,40,45
Yankee Ferry Terminal,40.68706579875912,-74.01675585121666,27,8,35
Sedgwick Ave & W Burnside Ave,40.854947,-73.916661,5,12,17
Maple St & Flatbush Ave,40.66026,-73.96045,15,1,16
5 St & Market St,40.699997484388504,-73.97440128028393,9,29,38
Southern Blvd & E 180 St,40.84605,-73.88426,4,14,18
65 Ln & Metropolitan Ave,40.7123,-73.89397,20,1,21
Van Sinderen Ave & Atlantic Ave,40.67621,-73.90351,5,15,20
Broadway & W 160 St,40.835775,-73.9434,2,17,19
W 55 St & 6 Ave,40.763189,-73.978434,3,69,72
Popham Ave & W 174 St,40.847746,-73.922079,10,6,16
Church Ave & Nostrand Ave,40.65074,-73.94986,15,9,24
Broadway & W 61 St,40.77003010255044,-73.9819684624672,24,24,48
Henry St & Atlantic Ave,40.69089272,-73.99612349,4,13,17
38 St & Northern Blvd,40.752372,-73.925384,12,7,19
21 St & 31 Dr,40.7659,-73.930819,6,9,15
Washington St,40.7242941,-74.0354826,7,8,15
57 St & 1 Ave,40.646377,-74.023087,19,8,27
Amsterdam Ave & W 136 St,40.819746,-73.951819,1,13,14
Columbia St & Kane St,40.68763155,-74.0016256,15,5,20
Clay Ave & E 173 St,40.843264,-73.904867,11,4,15
Scholes St & Manhattan Ave,40.70870368,-73.9448625,6,26,32
Alexander Ave & E 134 St,40.807466,-73.927107,10,8,18
E 58 St & 1 Ave (NE Corner),40.75892386377695,-73.96226227283478,4,25,29
55 Dr & Maurice Ave,40.7261,-73.90917,14,1,15
Rogers Ave & Snyder Ave,40.64871,-73.95218,14,6,20
6 Ave & Walker St,40.7197920901383,-74.0052238852195,21,16,37
Bushwick Ave & Stagg St,40.709897,-73.94008,4,15,19
Longwood Ave & Southern Blvd,40.816343,-73.896447,19,3,22
Brunswick & 6th,40.72601172964625,-74.05038893222809,3,11,14
E 138 St & Cypress Ave,40.805559,-73.914718,1,18,19
36 St & Hunters Point Ave,40.73781699881193,-73.93024072051048,2,18,20
E 142 St & 3 Ave,40.812735,-73.923697,13,6,19
E 20 St & 2 Ave,40.73587678,-73.98205027,2,78,80
Grand St & Samuel Dickstein Plaza,40.715118719964956,-73.98417055606842,44,26,70
43 Ave & 40 St,40.74562,-73.92402,2,19,21
1 Ave & E 18 St,40.733812191966315,-73.98054420948029,6,40,46
Smith St & 9 St,40.6746957,-73.99785768,13,6,19
Frederick Douglass Blvd & W 117 St,40.805159,-73.954692,23,7,30
18 St & 27 Ave,40.772768286288304,-73.92743647098541,4,18,22
Amsterdam Ave & W 183 St,40.84925,-73.93022,14,7,21
St Marks Ave & Ralph Ave,40.67372,-73.92199,12,5,17
St Nicholas Ave & W 155 St,40.830663,-73.941323,1,14,15
97 St & 23 Ave,40.7683,-73.87331,18,0,18
St Mary's St & Jackson Ave,40.808891,-73.91081,0,14,14
Wards Meadow Comfort Station,40.78294,-73.93077,3,11,14
Eastern Pkwy & St Marks Ave,40.67319,-73.91083,12,10,22
Amsterdam Ave & W 180 St,40.847396,-73.931205,5,16,21
Old Fulton St,40.70277159,-73.99383605,32,1,33
111 St & 37 Ave,40.75397,-73.85748,13,9,22
Flushing Ave & Woodward Ave,40.71246,-73.91873,12,7,19
E 56 St & 3 Ave,40.75934501,-73.96759673,1,71,72
Broadway & W 56 St,40.7652654,-73.98192338,2,103,105
Central Ave & Starr St,40.700003,-73.92834,4,17,21
Columbus Park - Clinton St & 9 St,40.74816121065146,-74.0324530005455,8,18,26
24 Ave & 87 St,40.7654,-73.88256,17,2,19
Seneca Ave & Decatur St,40.69723,-73.89811,1,17,18
Eastern Pkwy & Washington Ave,40.6716493,-73.9631145,28,3,31
Pulaski St & Throop Ave,40.693115,-73.943149,0,9,9
McGuinness Blvd & Eagle St,40.73555,-73.95284,32,9,41
Walton Ave & E 176 St,40.84833,-73.90971,18,2,20
Walton Ave & E 153 St,40.822351,-73.926907,14,4,18
37 Ave & 106 St,40.75397,-73.862,16,2,18
59 St & 59 Rd,40.71790852734058,-73.908454477787,19,1,20
24 Ave & 92 St,40.76589,-73.87789,17,1,18
E 15 St & 5 Ave,40.736592,-73.992949,7,65,72
3 Ave & E 72 St,40.7699426,-73.96060712,8,24,32
E 23 St & FDR Dr,40.736,-73.97605,2,43,45
Melrose St & Broadway,40.697481,-73.935877,4,15,19
Norman St & Wyckoff Ave,40.69517,-73.90311,2,12,14
W 20 St & 11 Ave,40.746745,-74.007756,66,4,70
Schenectady Ave & Prospect Pl,40.67351,-73.93363,1,14,15
Pacific St & Utica Ave,40.6767,-73.93051,3,16,19
7 Ave & 62 St,40.63556,-74.01298,23,5,28
Washington Ave & Park Ave,40.69610226,-73.96751037,44,5,49
Grand Concourse & E 175 St,40.84627592921954,-73.90931278467178,6,16,22
Bailey Ave & W 229 St,40.87449,-73.90467,20,0,20
Dwight St & Van Dyke St,40.67363551341504,-74.01195555925369,23,0,23
University Pl & E 14 St,40.734814,-73.992085,39,18,57
Sherman Ave & E 166 St,40.83130549267296,-73.91744792461395,6,11,17
Park Ave & St Edwards St,40.69608941,-73.97803415,46,6,52
Wakeman Pl & Ridge Blvd,40.639421,-74.026823,11,1,12
St Ann's Ave & Bruckner Blvd,40.803399,-73.919763,9,6,15
Herkimer St & New York Ave,40.67955,-73.94709,7,13,20
46 Ave & Junction Blvd,40.74399,-73.86781,16,2,18
Riverside Blvd & W 67 St,40.777507027547976,-73.98888587951659,19,55,74
Clinton Ave & Flushing Ave,40.69794,-73.96986848,4,15,19
Broadway & W 53 St,40.76344058,-73.98268129,2,79,81
Gleane St & Britton Ave,40.74646,-73.87996,3,17,20
Dock 72 Way & Market St,40.69985,-73.97141,2,20,22
West St & Liberty St,40.711444,-74.014847,43,3,46
E 85 St & York Ave,40.77536905,-73.94803392,19,25,44
38 Ave & 29 St,40.75473,-73.93367,1,17,18
Morris Ave & E 163 St,40.827230499624726,-73.91765579597632,2,13,15
Featherbed Ln & Jerome Ave,40.845505,-73.914311,13,7,20
Howard St & Lafayette St,40.71910537,-73.99973337,14,25,39
Mets Plaza at Citi Field,40.75521,-73.84672,19,17,36
36 St & Ditmars Blvd,40.774306,-73.908335,4,17,21
Jerome Ave & Anderson Ave,40.830179,-73.928747,9,6,15
W 53 St & 10 Ave,40.76669671,-73.99061728,3,22,25
E 182 St & Morris Ave,40.85670801831255,-73.90265285968779,7,10,17
65 Pl & Woodside Ave,40.74334,-73.89903,5,14,19
E 167 St & Bryant Ave,40.826706,-73.888719,7,8,15
Crescent St & 34 Ave,40.76108,-73.930562,10,17,27
E 74 St & 1 Ave,40.7689738,-73.95482273,3,74,77
Centre St & Seneca Ave,40.69969,-73.9022,4,17,21
Somers St & Broadway,40.67945,-73.90474,23,5,28
Central Park W & W 85 St,40.78476,-73.969862,25,3,28
Central Ave & Melrose St,40.70112,-73.93039,1,13,14
E 77 St & 3 Ave,40.77314236,-73.95856158,4,37,41
Stuyvesant Ave & Gates Ave,40.68834,-73.93306,1,21,22
Steinway St & 28 Ave,40.7656251,-73.9136695,12,13,25
South St & Gouverneur Ln,40.70355377,-74.00670227,30,13,43
Rogers Ave & Sterling St,40.6630619,-73.9538746,9,3,12
E 118 St & Madison Ave,40.8014866,-73.9442507,9,13,22
E 88 St & Park Ave,40.781410700190015,-73.95595908164978,32,0,32
Eagle St & Manhattan Ave,40.735217,-73.954926,34,0,34
E 38 St & Church Ave,40.65106,-73.94193,7,15,22
31 Ave & 84 St,40.75947,-73.88431,14,7,21
Pinehurst Ave & W 187 St,40.855331,-73.937878,0,18,18
King St & Varick St,40.72789701409023,-74.00536268949507,30,4,34
W 13 St & 7 Ave,40.73781509,-73.99994661,41,0,41
Bergen St & Kingston Ave,40.6756,-73.9415,5,17,22
Gillmore St & 27 Ave,40.76399,-73.8669,16,0,16
40 Ave & Crescent St,40.753599202005596,-73.93795609474182,1,22,23
Wilson Ave & Troutman St,40.70166,-73.92754,15,9,24
Wyckoff Ave & Jefferson St,40.707165,-73.923711,22,4,26
8 Ave & W 52 St,40.76370739,-73.9851615,5,24,29
W 18 St & 6 Ave,40.73971301,-73.99456405,19,46,65
35 St & 34 Ave,40.7580583,-73.9242751,8,13,21
Rivington St & Chrystie St,40.72110063,-73.9919254,63,1,64
50 Ave & 65 St,40.73707,-73.90077,14,3,17
E 40 St & Park Ave,40.750756,-73.978326,43,74,117
Grand Ave & W Fordham Rd,40.86288,-73.90316,3,17,20
Broadway & Ellwood St,40.862058,-73.929719,4,10,14
Clifton Pl & Bedford Ave,40.688655,-73.955156,13,6,19
64 St & 3 Ave,40.639978,-74.02324,27,4,31
Adam Clayton Powell Blvd & W 115 St,40.802535,-73.9532423,16,2,18
Hoe Ave & Jennings St,40.832171,-73.889686,4,14,18
61 St & 60 Ln,40.70055,-73.8943,5,10,15
Clinton St & Grand St,40.71559509,-73.9870295,34,29,63
Brooklyn Ave & Beverley Rd,40.64575,-73.94331,8,9,17
4 Ave & Shore Road Dr,40.637033,-74.022141,15,1,16
Forest Ave & Summerfield St,40.69922,-73.89795,9,14,23
Windsor Pl & Howard Pl,40.659490558938955,-73.98013919591904,6,4,10
92 St & 37 Ave,40.75085,-73.87509,5,13,18
Jackson Ave & 46 Rd,40.74524768,-73.94733276,17,10,27
Hancock St & Malcolm X Blvd,40.68487,-73.9293,5,10,15
York St & Marin Blvd,40.716615000830494,-74.0424120426178,9,9,18
Marcy Ave & Lynch St,40.702753,-73.953168,18,3,21
Margaret Corbin Plz & Ft Washington Ave,40.859166,-73.933872,5,15,20
City Hall,40.7177325,-74.043845,12,5,17
Hart St & Wyckoff Ave,40.704876,-73.919911,2,21,23
Franklin Ave & Quincy St,40.68636,-73.95678,1,19,20
Wales Ave & E 147 St,40.811314,-73.907729,3,14,17
Lefferts Pl & Franklin Ave,40.680342423,-73.9557689392,7,15,22
Southern Blvd & E 172 St,40.834124,-73.88955,8,8,16
Kingston Ave & E New York Ave,40.66219,-73.94293,14,7,21
E 24 St & Park Ave S,40.74096374,-73.98602213,1,76,77
Gold St & Frankfort St,40.71069995,-74.00354147,11,27,38
Orchard St & Grand St,40.717318403855785,-73.99067759513855,36,4,40
Butler St & Court St,40.6849894,-73.99440329,11,23,34
Newtown Ave & 23 St,40.7713615,-73.9246145,4,22,26
Park Ave & Marcus Garvey Blvd,40.698617,-73.941342,7,14,21
23 Ave & 83 St,40.76646,-73.88674,19,0,19
W 22 St & 10 Ave,40.74691959,-74.00451887,10,58,68
E 184 St & 3 Ave,40.85472,-73.89022,14,4,18
Warren St & W Broadway,40.71473993,-74.00910627,15,49,64
Central Park W & W 72 St,40.77579376683666,-73.9762057363987,42,2,44
Grand Concourse & E 203 St,40.87382,-73.88661,10,14,24
49 St & 31 Ave,40.758057,-73.909831,10,9,19
N 9 St & Wythe Ave,40.72054,-73.959,23,24,47
Church St & Worth St,40.71688538495366,-74.00650128722191,24,17,41
Columbus Ave & W 95 St,40.7919557,-73.968087,20,7,27
Lexington Ave & Stuyvesant Ave,40.68973,-73.93353,0,14,14
E 16 St & 5 Ave,40.73726186,-73.99238967,55,4,59
Baldwin at Montgomery,40.7236589,-74.0641943,3,11,14
35 Ave & 37 St,40.7557327,-73.9236611,12,17,29
E 20 St & FDR Dr,40.733208626522426,-73.9756813647,10,62,72
Loring Pl North & W 183 St,40.8604244,-73.9093359997,6,11,17
8 Ave & W 38 St,40.75461,-73.99177,21,42,63
Dawson St & Intervale Ave,40.819999,-73.897263,14,0,14
Harborside,40.7192517,-74.034234,14,14,28
Ave C & E 16 St,40.72984830346529,-73.97455215454102,5,41,46
Thomas S. Boyland St & Marion St,40.6814658848122,-73.91415685415268,5,10,15
10 St & 5 Ave,40.6686273,-73.98700053,15,4,19
Kent St & McGuinness Blvd,40.73124,-73.95161,18,2,20
St Johns Pl & Howard Ave,40.66992,-73.92002,9,12,21
Mount Eden Pkwy & Eastburn Ave,40.842675,-73.908544,10,9,19
31 Ave & Crescent St,40.7658346,-73.9265474,0,19,19
W 20 St & 10 Ave,40.745686,-74.005141,41,3,44
E 11 St & 3 Ave,40.73127,-73.98849,63,12,75
Ave D & E 8 St,40.72368361,-73.97574813,9,17,26
Frederick Douglass Blvd & W 129 St,40.8125511,-73.9492286,21,3,24
Brooklyn Ave & Lefferts Ave,40.662564,-73.945565,18,1,19
Clarkson Ave & Nostrand Ave,40.6555,-73.94975,15,7,22
Academy St & Nagle Ave,40.862562,-73.922661,9,9,18
Henry St & Degraw St,40.6847514,-73.99917254,17,3,20
Schenectady Ave & Cortelyou Rd,40.64535,-73.93268,18,0,18
6 Ave & W 45 St,40.756951,-73.982631,25,35,60
20 Ave & 38 St,40.777112,-73.902382,25,0,25
W 204 St & Vermilyea Ave,40.866141,-73.922648,10,9,19
Marcy Ave & Rutledge St,40.703681,-73.95427,2,17,19
Stratford Rd & Beverley Rd,40.64378,-73.96867,12,2,14
Broadway & Kosciuszko St,40.69329,-73.92852,0,29,29
W 34 St & 11 Ave,40.75594159,-74.0021163,22,54,76
51 Ave & Alstyne Ave,40.74311,-73.85715,15,5,20
57 St & Grand Ave,40.71921,-73.9124,3,16,19
Grand Concourse & E 167 St,40.834263,-73.917641,3,21,24
E 16 St & Irving Pl,40.735367055605394,-73.98797392845154,15,58,73
Marcy Ave & Hart St,40.693022,-73.94868,0,13,13
McKibbin St & Manhattan Ave,40.70510918,-73.94407279,5,17,22
George St & Wilson Ave,40.702997,-73.92997,11,5,16
W 107 St & Columbus Ave,40.7997568,-73.9621128676,5,10,15
W 52 St & 5 Ave,40.75992262,-73.97648516,35,21,56
Madison Ave & E 82 St,40.7781314,-73.96069399,28,4,32
W 230 St & Marble Hill Ave,40.87807,-73.90796,18,5,23
Peck Slip & South St,40.7075188830923,-74.00108054280281,35,3,38
Pier 61 at Chelsea Piers,40.746872,-74.00821,22,10,32
River Ave & McClellan St,40.83406,-73.92243,12,7,19
William St & Pine St,40.70717936,-74.00887308,6,47,53
3 Ave & Wakeman Pl,40.638246,-74.024714,24,3,27
Lafayette Ave & Hunts Point Ave,40.816567,-73.888161,4,12,16
Manhattan Ave & Devoe St,40.713532,-73.9459867,20,2,22
Grand Concourse & E 166 St,40.83196,-73.91956,3,19,22
48 Ave & 5 St,40.744363287066875,-73.9558732509613,72,5,77
Webster Ave & E 166 St,40.828975,-73.911259,14,2,16
96 St & Northern Blvd,40.75712,-73.8722,10,8,18
W 106 St & Amsterdam Ave,40.8008363,-73.9664492472,11,22,33
Newport PATH,40.7272235,-74.0337589,2,11,13
E Mosholu Pkwy & E 204 St,40.8740704,-73.8833650931,5,12,17
E 16 St & Cortelyou Rd,40.64173,-73.96364,18,4,22
39 Ave & 56 St,40.74838,-73.90699,11,6,17
37 St & 24 Ave,40.7701477,-73.9120938,8,8,16
E 47 St & 1 Ave,40.75206862,-73.96784384,3,61,64
Sullivan St & Washington Sq,40.73047747,-73.99906065,47,2,49
57 St & 4 Ave,40.642622,-74.016866,9,5,14
Bialystoker Pl & Delancey St,40.71622644,-73.98261206,14,14,28
Henry St & Grand St,40.714211,-73.981095,11,24,35
Pioneer St & Van Brunt St,40.679043,-74.011169,32,0,32
Waverly Ave & Lafayette Ave,40.688231,-73.966804,2,13,15
Murray St & Greenwich St,40.714851505262516,-74.01122331619263,34,6,40
E 60 St & York Ave,40.759107,-73.959223,10,20,30
Dahill Rd & 12 Ave,40.646037,-73.980963,2,18,20
Waterbury St & Stagg St,40.71019,-73.93734,21,2,23
Greenwich St & Rector St,40.70806582380646,-74.0135595202446,53,5,58
E 58 St & Madison Ave,40.76302594280519,-73.97209525108337,15,49,64
24 St & 5 Ave,40.659555,-73.995068,12,1,13
Broadway & W 29 St,40.7462009,-73.98855723,35,60,95
E 171 St & Webster Ave,40.838379,-73.905838,10,3,13
E 48 St & 5 Ave,40.75724567911726,-73.97805914282799,3,57,60
Fulton St & Irving Pl,40.68186,-73.959432,7,21,28
3 St & Hoyt St,40.6777287,-73.99364123,47,1,48
39 Ave & 54 St,40.74891,-73.90899,4,13,17
Kosciuszko St & Tompkins Ave,40.69128258,-73.9452416,0,14,14
60 Pl & Linden St,40.70886,-73.90182,5,15,20
Grand Ave & 55 St,40.71888,-73.91427,12,7,19
E 7 St & Ave C,40.72412944090093,-73.97901266813278,2,27,29
Fort Washington Ave & W 183 St,40.852252,-73.937854,5,20,25
Wyckoff Ave & Stanhope St,40.703545,-73.917775,9,13,22
E 89 St & York Ave,40.7779453,-73.946041,28,1,29
Clinton St & Cherry St,40.711471394469264,-73.98672603070736,14,17,31
E 53 St & Madison Ave,40.7597108,-73.97402311,0,0,0
48 Ave & 41 St,40.73985995699164,-73.92400324344635,3,15,18
Spring St & Hudson St,40.72583996792375,-74.0076532959938,48,13,61
3 Ave & Carroll St,40.677027,-73.9865,20,5,25
Broadway & E 21 St,40.739888408589955,-73.98958593606949,15,28,43
W 56 St & 6 Ave,40.76340613,-73.97722479,10,35,45
Crotona Ave & Crotona Park N,40.84234,-73.89409,0,18,18
6 Ave & 55 St,40.640831,-74.010996,1,17,18
River Ter & Warren St,40.71759894980997,-74.01587963104248,67,1,68
Forsyth St & Grand St,40.71779817737835,-73.99316132068634,57,0,57
W 218 St & Indian Rd,40.873054589370895,-73.91837194561958,7,12,19
Bedford Ave & S 9 St,40.70853074,-73.96408963,5,15,20
78 St & Northern Blvd,40.75499,-73.88905,24,16,40
Prospect Pl & Nostrand Ave,40.67428,-73.9503,1,17,18
51 Ave & Van Loon St,40.73832,-73.87913,21,2,23
Westchester Ave & Jackson Ave,40.816124,-73.908116,13,8,21
E 82 St & East End Ave,40.7724607,-73.9468208,15,16,31
E 141 St & St Ann's Ave,40.808633,-73.916124,9,4,13
Broadway & 51 St,40.754164,-73.908906,12,12,24
Chauncey St & Malcolm X Blvd,40.68044,-73.92842,3,19,22
E 169 St & Fox St,40.827184,-73.893721,1,17,18
Knickerbocker Ave & Hancock St,40.69385,-73.90974,2,17,19
W 35 St & 9 Ave,40.75414519263519,-73.9960889518261,5,26,31
Davidson Ave & W Burnside Ave,40.853646,-73.908731,22,10,32
Marcy Ave & Lafayette Ave,40.6900815,-73.947915,13,4,17
Wyckoff Ave & Cooper Ave,40.69338,-73.90061,6,10,16
Woodhaven Blvd & Hoffman Dr,40.73303,-73.871,22,2,24
11 St & Washington St,40.74998490907138,-74.02715027332306,20,0,20
W 13 St & 5 Ave,40.735445,-73.99431,18,19,37
E 21 St & Church Ave,40.65007,-73.96001,20,2,22
Columbus Pl & Atlantic Ave,40.67717,-73.92285,1,16,17
Warren St & Roosevelt Ave,40.74919,-73.87054,16,3,19
Madison St & Malcolm X Blvd,40.68713,-73.93008,0,24,24
W 100 St & Manhattan Ave,40.795,-73.9645,10,27,37
W 46 St & 11 Ave,40.76341379,-73.99667444,5,13,18
Fairmount Pl & Prospect Ave,40.843099,-73.889927,5,10,15
20 Ave & 42 St,40.775415,-73.900063,15,4,19
Schenectady Ave & Maple St,40.66178,-73.93445,16,2,18
Fresh Pond Rd & Flushing Ave,40.72155,-73.90295,11,6,17
32 Ave & 84 St,40.75793,-73.88401,10,8,18
60 Ave & Junction Blvd,40.73466,-73.86501,22,1,23
7 St & Monroe St,40.74641264837719,-74.03797701001167,5,17,22
Lenox Ave & W 126 St,40.808442,-73.9452087,22,9,31
Macombs Rd & W 175 St,40.848177,-73.916082,0,18,18
Bergen St & Buffalo Ave,40.6747,-73.92512,2,18,20
3 Ave & E 172 St,40.839586,-73.900277,9,8,17
Greene Ave & Myrtle Ave,40.698568,-73.918877,15,13,28
64 St & 53 Dr,40.72897,-73.90115,16,2,18
Sharon St & Olive St,40.715341620424475,-73.93865078687668,6,15,21
Cedar St & Evergreen Ave,40.69671,-73.92807,2,22,24
Bainbridge Ave & Bedford Park Blvd,40.87002,-73.88565,12,5,17
33 St & 47 Ave,40.74283,-73.9321,15,7,22
Southwest Park - Jackson St & Observer Hwy,40.73755127245804,-74.04166370630264,13,7,20
Henry St & Remsen St,40.69400964865994,-73.99465128779411,2,14,16
Bedford Ave & Beverley Rd,40.64491,-73.95487,22,2,24
E 170 St & Sheridan Ave,40.838315,-73.912604,5,24,29
Degraw St & Smith St,40.6829151,-73.99318208,16,9,25
Front St & Washington St,40.70255088,-73.98940236,48,3,51
37 Ave & 113 St,40.75475,-73.8549,29,1,30
Ocean Ave & Crooke Ave,40.65326,-73.96172,16,9,25
W 116 St & Broadway,40.8082,-73.9641,3,23,26
W Tremont Ave & Matthewson Rd,40.853827,-73.920765,10,6,16
E 128 St & Madison Ave,40.80756,-73.939182,16,4,20
Valentine Ave & E 181 St,40.854123869116,-73.89932222664356,4,16,20
Macon St & Nostrand Ave,40.6809833854,-73.9500479759,11,13,24
5 Ave & E 135 St,40.812191,-73.937838,9,11,20
Butler St & 27 Ave,40.76521,-73.86483,15,2,17
Macombs Rd & Featherbed Ln,40.84552,-73.91722,13,3,16
30 Ave & 41 St,40.763422,-73.914142,8,13,21
Tompkins Ave & Hopkins St,40.69957608,-73.94708417,10,5,15
Menahan St & Onderdonk Ave,40.70553,-73.9096,6,11,17
Sterling St & Nostrand Ave,40.66318,-73.95076,10,8,18
7 Ave & 17 St,40.660937794931684,-73.98680448532104,13,3,16
W 50 St & 9 Ave,40.763604677958625,-73.98917958140373,6,15,21
E Houston St & Columbia St,40.71978635452822,-73.97871628403664,21,23,44
Fulton St & Utica Ave,40.6794268,-73.9298911,6,12,18
Grand St & Elizabeth St,40.718822,-73.99596,25,9,34
New York Ave & St Marks Ave,40.67514,-73.94716,3,17,20
Vernon Blvd & 50 Ave,40.74232744,-73.95411749,34,8,42
Bradley Ave & Greenpoint Ave,40.73565914819229,-73.93478840589523,15,6,21
E 25 St & 2 Ave,40.73912601,-73.97973776,1,71,72
W 36 St & 9 Ave,40.75462324029105,-73.99516761302948,0,0,0
36 Ave & 10 St,40.7614376,-73.9411265,8,11,19
E 49 St & Church Ave,40.65182,-73.93135,23,1,24
Graham Ave & Conselyea St,40.715143,-73.944507,8,21,29
Lispenard St & Broadway,40.71939226,-74.00247214,64,13,77
Paul Ave & Mosholu Pkwy,40.8802945,-73.8860653648,18,1,19
Center Blvd & 48 Ave,40.745038,-73.957539,22,5,27
Gerard Ave & McClellan St,40.833909,-73.92112,8,20,28
Metropolitan Ave & Flushing Ave,40.71334,-73.91572,3,15,18
Lenox Ave & W 140 St,40.817245,-73.938787,3,19,22
W 147 St & Adam Clayton Powell Blvd,40.82281,-73.937413,6,15,21
31 St & Broadway,40.76211,-73.92523,20,14,34
E 33 St & 1 Ave,40.74322681432173,-73.97449783980846,14,69,83
Marble Hill Ave & W 225 St,40.87471,-73.91099,17,1,18
Madison St & Cypress Ave,40.70068,-73.90742,1,14,15
Church Ave & McDonald Ave,40.642809,-73.979239,5,23,28
23 St & 3 Ave,40.662611,-73.998623,19,3,22
St Nicholas Terrace & Convent Ave,40.821294,-73.947868,0,21,21
Eastern Pkwy & Troy Ave,40.66929,-73.93679,10,14,24
Queens Plaza North & Crescent St,40.75110165,-73.94073717,4,26,30
Lenox Rd & E 43 St,40.65496,-73.93765,10,9,19
108 St & 52 Ave,40.74310053056842,-73.85466891367044,9,26,35
Menahan St & Central Ave,40.69543,-73.9196,2,19,21
Columbus Drive,40.71835519823214,-74.03891444206238,7,7,14
Church Ave & E 42 St,40.65127,-73.93818,5,19,24
8 St & Washington St,40.745983882915624,-74.02819901704788,12,5,17
Broadway & W 131 St,40.817555,-73.957163,8,10,18
62 St & 4 Ave,40.639859,-74.019776,14,4,18
Cumberland St & Lafayette Ave,40.68753406,-73.97265183,8,22,30
Ditmars Blvd & 94 St,40.7702,-73.87587,14,4,18
1 Ave & E 16 St,40.73221853,-73.98165557,0,53,53
Lexington Ave & Patchen Ave,40.6904,-73.9277,4,12,16
61 St & Laurel Hill Blvd,40.7388,-73.90338,9,8,17
Rogers Ave & Lenox Rd,40.65378,-73.95273,7,14,21
4 Ave & 26 St,40.660079,-73.998633,19,1,20
Willow Ave & E 133 St,40.800933,-73.913863,18,1,19
Classon Ave & St Marks Ave,40.676513,-73.959431,4,20,24
Bradhurst Ave & W 148 St,40.825125,-73.941616,8,9,17
Broadway & W 48 St,40.76017739537783,-73.98486793041229,35,59,94
9 Ave & W 33 St,40.752568,-73.996765,15,75,90
Cortelyou Rd & Stratford Rd,40.63966,-73.96807,17,2,19
3 Ave & E 163 St,40.823872,-73.908699,18,7,25
Pike St & Monroe St,40.71173107,-73.99193043,26,1,27
40 Ave & 9 St,40.75742,-73.945133,9,9,18
44 St & 3 Ave,40.651173,-74.011405,19,4,23
53 St & 5 Ave,40.643371,-74.011884,1,28,29
Parade Pl & Crooke Ave,40.651847,-73.965248,17,11,28
Lafayette St & E 8 St,40.73020660529954,-73.99102628231049,29,64,93
52 St & 6 Ave,40.642703,-74.009441,4,12,16
Church Ave & Story St,40.642031,-73.981073,7,16,23
Westchester Ave & E 156 St,40.817802,-73.905203,12,6,18
34 St & 38 Ave,40.752443,-73.929737,13,10,23
65 St & 2 Ave,40.640493,-74.02564,17,4,21
Crown St & Rogers Ave,40.66639,-73.95346,0,18,18
Westchester Ave & Southern Blvd,40.824956,-73.891677,9,11,20
Dey St,40.737711,-74.066921,9,9,18
W 4 St & 7 Ave S,40.73401143,-74.00293877,57,1,58
35 St & 21 Ave,40.776745,-73.906558,4,15,19
63 St & 5 Ave,40.63766,-74.01782,21,2,23
42 Pl & Northern Blvd,40.753091,-73.920603,15,9,24
E 7 St & Ave A,40.72621788,-73.98379855,13,29,42
1 Pl & Clinton St,40.6809591,-73.99905709,27,4,31
W 30 St & 10 Ave,40.752694,-74.002353,19,19,38
W 22 St & 8 Ave,40.74475148,-73.99915362,10,51,61
Grand St & Havemeyer St,40.71286844,-73.95698119,18,10,28
Pershing Field,40.742677141,-74.051788633,0,17,17
Grand Concourse & E 164 St,40.829608,-73.921461,2,18,20
Fresh Pond Rd & 69 Ave,40.70311,-73.89547,1,26,27
Putnam Ave & Wyckoff Ave,40.69811,-73.90904,8,16,24
Frederick Douglass Blvd & W 145 St,40.823061,-73.941928,14,11,25
Bergen Ave & Sip Ave,40.73100888698729,-74.06443700194359,12,18,30
Washington Ave & Empire Blvd,40.66314,-73.9605695,21,5,26
3 St & 3 Ave,40.6750705,-73.98775226,76,1,77
Vyse Ave & E 181 St,40.84463,-73.87988,6,14,20
W 59 St & 10 Ave,40.770513,-73.988038,2,114,116
Broadway & W 165 St,40.839137,-73.941409,2,21,23
Broadway & W 36 St,40.75097711,-73.98765428,8,68,76
Park Ave & E 42 St,40.751873,-73.977706,55,22,77
Cortelyou Rd & Argyle Rd,40.64034,-73.96603,19,1,20
5 Corners Library,40.734961020009514,-74.0595030784607,2,14,16
W 27 St & 7 Ave,40.74665,-73.99392,10,59,69
60 Pl & 67 Ave,40.70497,-73.89965,1,14,15
21 Ave & Shore Blvd,40.783956,-73.916894,7,9,16
Nagle Ave & Ellwood St,40.86012,-73.928489,13,6,19
Washington Ave & Park Pl,40.675832,-73.963308,3,29,32
Ocean Pkwy & Church Ave,40.644718957635746,-73.97451460361481,11,12,23
Greenpoint Ave & West St,40.729803,-73.959099,31,1,32
St Nicholas Ave & Manhattan Ave,40.809725,-73.953149,22,3,25
Newark Ave,40.72152515,-74.046304543,8,9,17
Corona Ave & 102 St,40.74419,-73.8619,10,9,19
38 St & 30 Ave,40.764174520197685,-73.91583994030952,3,22,25
MacDougal St & Rockaway Ave,40.68018,-73.91136,11,9,20
35 St & 30 Ave,40.76547569244953,-73.91811579465866,2,21,23
Herkimer St & Eastern Pkwy,40.67738,-73.90829,3,13,16
Macon St & Patchen Ave,40.68374,-73.9261,11,5,16
W 25 St & 9 Ave,40.747832605837715,-74.0005722643582,2,65,67
Riverside Dr & W 148 St,40.829114,-73.950426,0,20,20
21 St & 36 Ave,40.7601853,-73.9362726,8,11,19
Tiebout Ave & E Fordham Rd,40.861915,-73.894831,11,11,22
65 St & Broadway,40.749372273899596,-73.89738768339157,8,10,18
W 225 St & Exterior St,40.873265,-73.906646,15,0,15
W 211 St & 10 Ave,40.86709406268147,-73.9172950387001,13,3,16
Willow Ave & 12 St,40.7518674823282,-74.03037697076797,12,1,13
48 St & 5 Ave,40.646351,-74.009271,9,15,24
3 Ave & E 62 St,40.76313,-73.96527,12,34,46
Sherman Ave & Thayer St,40.863124,-73.926994,17,3,20
Suydam St & Broadway,40.69544,-73.93223,6,19,25
Spruce St & Nassau St,40.71146364,-74.00552427,7,24,31
47 Ave & 48 St,40.74086,-73.91708,2,17,19
52 St & 1 Ave,40.649292,-74.020105,18,3,21
Fulton St & Saratoga Ave,40.67853,-73.91642,13,5,18
Lorimer St & Calyer St,40.72795,-73.95414,14,5,19
62 St & Northern Blvd,40.754176,-73.900318,18,7,25
Graham Ave & Grand St,40.711863,-73.944024,7,17,24
21 St & 38 Ave,40.7576314,-73.9391224,1,18,19
West St & Chambers St,40.71754834,-74.01322069,107,0,107
48 St & Skillman Ave,40.74622874694195,-73.91616314649582,1,21,22
69 St & 38 Ave,40.74694504524519,-73.89650255441666,11,12,23
Grand Ave & Remsen Pl,40.72353,-73.89967,16,2,18
Amsterdam Ave & W 131 St,40.816355,-73.954295,3,15,18
Ash St & Manhattan Ave,40.738095,-73.954867,11,20,31
Amsterdam Ave & W 119 St,40.8086249,-73.9596214,2,23,25
India St & Manhattan Ave,40.73232194,-73.9550858,45,2,47
E 76 St & Park Ave,40.773763,-73.96222088,3,25,28
2 Ave & E 122 St,40.8006721,-73.9349,6,11,17
Columbus Ave & W 103 St,40.7969347,-73.9643412291,1,33,34
Judge St & Britton Ave,40.74454,-73.88112,8,14,22
Richardson St & N Henry St,40.71907891179564,-73.94223690032959,7,15,22
E 44 St & 2 Ave,40.75118387463277,-73.97138714790344,1,37,38
Walton Ave & E 168 St,40.83649,-73.918316,3,12,15
31 Ave & 34 St,40.763154,-73.920827,11,9,20
Irving Ave & DeKalb Ave,40.7027,-73.92095,16,9,25
E 65 St & 2 Ave,40.76471851944339,-73.96222069859505,13,31,44
23 Ave & 31 St,40.77423301703027,-73.91274864321404,3,21,24
28 Ave & 44 St,40.76408932350688,-73.91065120697021,4,12,16
1 Ave & E 62 St,40.7612274,-73.96094022,13,29,42
42 St & 1 Ave,40.654798,-74.014372,16,2,18
Boston Rd & West Farms Rd,40.83998,-73.8806,22,1,23
Leonard Gordon Park,40.74590996631558,-74.0572714805603,2,12,14
Humboldt St & Varet St,40.7031724,-73.940636,30,5,35
5 Ave & E 103 St,40.7922553,-73.95249933,27,3,30
White St & Moore St,40.704508,-73.9351,16,0,16
21 Ave & 80 St,40.770888,-73.889914,14,5,19
Johnson St & Gold St,40.69474881,-73.98362464,10,31,41
24 Ave & 29 St,40.7729,-73.916142,17,26,43
Myrtle Ave & Fleet Pl,40.693534,-73.981909,2,41,43
Amsterdam Ave & W 167 St,40.839443,-73.937044,3,12,15
Morgan Ave & Maspeth Ave,40.716657,-73.93637,23,1,24
Kingston Ave & Carroll St,40.66688,-73.9425,4,16,20
W 110 St & Amsterdam Ave,40.802692,-73.96295,3,36,39
Morris Ave & E 171 St,40.83899,-73.9109,13,6,19
71 St & 32 Ave,40.75675,-73.89595,12,6,18
41 St & 3 Ave,40.652512,-74.008906,19,0,19
W 146 St & Broadway,40.826969,-73.949738,1,27,28
West End Ave & W 107 St,40.8021174,-73.9681805305,1,24,25
7 Ave & W 55 St,40.764126,-73.980973,0,64,64
Borden Ave & Review Ave,40.73866345465306,-73.94093804061413,7,11,18
W 20 St & 7 Ave,40.74238787,-73.99726235,2,34,36
E 171 St & 3 Ave,40.837119,-73.902185,11,8,19
E 51 St & Linden Blvd,40.65399,-73.92967,17,2,19
Graham Ave & Herbert St,40.71929301,-73.94500379,5,18,23
New York Ave & Hawthorne St,40.65794,-73.94735,13,5,18
65 St & Otto Rd,40.70389,-73.89116,8,11,19
Union St,40.7182113,-74.0836394,17,1,18
21 St & 4 Ave,40.662584,-73.995554,21,0,21
W 140 St & Riverside Dr,40.824013,-73.954743,0,23,23
Greenpoint Ave & Monitor St,40.73224,-73.94383,10,10,20
Prospect Ave & Jennings St,40.831762,-73.896853,3,17,20
Broadway & Hancock St,40.68663,-73.9168,7,26,33
Mama Johnson Field - 4 St & Jackson St,40.74313993965626,-74.04004096984863,7,13,20
8 Ave & W 16 St,40.740983,-74.001702,13,17,30
Mt Morris Park W & W 120 St,40.804038,-73.945925,9,12,21
Jerome Ave & W 177 St,40.850121,-73.910765,19,8,27
River St & 1 St,40.73721535335381,-74.02886540972803,7,14,21
W 104 St & Amsterdam Ave,40.799041392882984,-73.96649479866028,6,36,42
Longfellow Ave & E 165 St,40.825322,-73.887729,13,4,17
Hudson Blvd W & W 36 St,40.75676475086503,-73.99971440439913,4,41,45
Corona Ave & 98 St,40.74448,-73.86516,12,6,18
Bailey Ave & W 238 St,40.88417,-73.89793,15,0,15
Clarkson Ave & E 40 St,40.65592,-73.94068,23,6,29
Clermont Ave & Lafayette Ave,40.68764484,-73.96968902,15,33,48
30 St & 4 Ave,40.657743,-74.001141,16,1,17
W Mosholu Pkwy S & Sedgwick Ave,40.88226,-73.88702,7,29,36
W 218 St & Broadway,40.87139,-73.914318,17,8,25
Amsterdam Ave & W 66 St,40.7746671,-73.98470567,3,14,17
E 2 St & 2 Ave,40.72502876,-73.99069656,76,0,76
Gramercy Park N & Gramercy Park E,40.73795,-73.98509,3,38,41
Bergen St & Flatbush Ave,40.680944723477296,-73.97567331790923,15,11,26
36 Ave & 31 St,40.75651272984955,-73.92957486212252,12,15,27
Albemarle Rd & E 21 St,40.64741,-73.95933,14,4,18
Water St & Gouverneur Ln,40.70469667894968,-74.00803416967392,20,13,33
Park Pl & Utica Ave,40.67242,-73.93094,1,16,17
Willis Ave & E 143 St,40.812299,-73.92037,6,15,21
Meserole Ave & Manhattan Ave,40.72708584,-73.95299117,24,3,27
2 St & Park Ave,40.73915272763701,-74.0330819785595,7,7,14
Featherbed Ln & Nelson Ave,40.846011,-73.919637,2,18,20
E 5 St & Cooper Sq,40.72769,-73.990993,8,34,42
E 84 St & Park Ave,40.77862688,-73.95772073,41,1,42
67 Ave & Fresh Pond Rd,40.70575,-73.89676,4,24,28
Valentine Ave & E 183 St,40.856987,-73.898237,4,17,21
E 123 St & Lexington Ave,40.8029263,-73.9379,20,4,24
71 Ave & Myrtle Ave,40.70067,-73.89907,1,26,27
Crescent St & Broadway,40.7633589,-73.9286471,7,9,16
Anthony Ave & E 175 St,40.846465,-73.903869,2,15,17
53 St & Flushing Ave,40.71435,-73.91405,1,17,18
Bedford Ave & Nassau Ave,40.72311651,-73.95212324,46,2,48
E 33 St & 5 Ave,40.74765947,-73.98490707,0,0,0
62 St & 34 Ave,40.75201,-73.89986,17,2,19
Riverside Dr & W 72 St,40.78057799010334,-73.98562431335449,10,28,38
E 43 St & Madison Ave,40.75354681867074,-73.97896572947502,37,16,53
Hunts Point Ave & Bryant Ave,40.813991,-73.8855,11,10,21
Bank St & Washington St,40.7361967,-74.00859207,14,13,27
104 St & 32 Ave,40.75951,-73.86491,8,11,19
Sterling Pl & Classon Ave,40.6739411,-73.96026,3,21,24
Norman Ave & Leonard St,40.725819,-73.950815,12,18,30
Madison St & Montgomery St,40.713126,-73.984844,7,7,14
43 St & 50 Ave,40.73787237950538,-73.92264068126678,2,16,18
E 138 St & Park Ave,40.81263616769319,-73.92924964427948,16,4,20
Lafayette Ave & St James Pl,40.68851534,-73.9647628,4,29,33
Crotona Ave & E Fordham Rd,40.8579,-73.88147,8,13,21
Arthur Ave & E Tremont Ave,40.84616,-73.89322,7,10,17
4 Ave & E 12 St,40.732647,-73.99011,32,0,32
Van Cortlandt Park S & Dickinson Ave,40.88435,-73.88781,7,17,24
Pulaski St & Marcus Garvey Blvd,40.6933982,-73.939877,0,18,18
Clarkson Ave & Utica Ave,40.65666,-73.93109,10,7,17
Adam Clayton Powell Blvd & W 126 St,40.809495347779475,-73.94776493310928,26,4,30
86 St & 37 Ave,40.75,-73.88062,1,15,16
43 St & Broadway,40.7577284,-73.9166368,4,19,23
3 St & 7 Ave,40.6703837,-73.97839676,9,11,20
Carroll St & Franklin Ave,40.6679411,-73.9588,4,12,16
Broadway & W 142 St,40.824686,-73.951947,1,20,21
Broadway & Furman Ave,40.68139,-73.90756,12,15,27
3 Ave & E 112 St,40.795508,-73.941606,19,4,23
River Ave & E 151 St,40.822217,-73.928939,22,2,24
72 St & Woodside Ave,40.74288,-73.89283,3,15,18
32 Ave & 75 St,40.75704,-73.8924,14,4,18
9 Ave & W 45 St,40.76019252,-73.9912551,12,15,27
Fairview Ave & Linden St,40.70694,-73.90632,5,12,17
W 36 St & 7 Ave,40.752149,-73.989539,11,23,34
E 53 St & 3 Ave,40.75763227739443,-73.96930575370789,2,39,41
Prospect Ave & Longwood Ave,40.81899,-73.90202,4,23,27
Washington Ave & E 174 St,40.843079,-73.900216,12,6,18
White St & Johnson Ave,40.707174,-73.93581,17,3,20
Vernon Blvd & 47 Rd,40.7449067,-73.9534573,28,2,30
Washington Pl & Broadway,40.72903917,-73.99404649,25,0,25
Isham St & Broadway,40.86788,-73.919685,23,4,27
Amsterdam Ave & W 156 St,40.832081,-73.942386,0,25,25
12 Ave & W 40 St,40.76087502,-74.00277668,21,52,73
Pacific St & Thomas S. Boyland St,40.67568,-73.91396,7,14,21
W Broadway & W Houston St,40.726378,-74.000472,47,1,48
Eames Pl & Claflin Ave,40.8692,-73.90121,0,20,20
Skillman Ave & 54 St,40.745502,-73.909887,1,15,16
Brook Ave & E 157 St,40.820713,-73.911759,6,9,15
34 Ave & Vernon Blvd,40.76535380385866,-73.93986314535141,17,11,28
46 St & 7 Ave,40.644743,-74.003754,3,17,20
45 Rd & 11 St,40.74708586,-73.94977234,6,15,21
Jerome Ave & W Fordham Rd,40.86294,-73.90108,7,14,21
Rugby Rd & Beverley Rd,40.64435,-73.96591,20,4,24
Troy Ave & Park Pl,40.67251,-73.93642,14,1,15
Madison Ave & E 26 St,40.742684734875695,-73.98671329021454,4,70,74
Adam Clayton Powell Blvd & W 118 St,40.804372,-73.951475,18,3,21
University Ave & W Burnside Ave,40.85501,-73.910751,0,23,23
W 31 St & 7 Ave,40.749156,-73.9916,61,15,76
Arthur Ave & E 183 St,40.85307,-73.88953,14,9,23
W 70 St & Amsterdam Ave,40.77748046,-73.98288594,8,28,36
Putnam Ave & Knickerbocker Ave,40.69545,-73.91164,2,25,27
Broadway & W 238 St,40.88524,-73.90077,28,0,28
97 St & 57 Ave,40.73727,-73.86415,8,12,20
Macon St & Howard Ave,40.68452,-73.92011,16,3,19
Parkside Ave & Parade Pl,40.6532,-73.96639,16,3,19
Cortelyou Rd & E 19 St,40.64269,-73.96099,15,7,22
Hughes Ave & Oak Tree Pl,40.85079,-73.88945,14,4,18
Motorgate,40.7639089,-73.9477213,21,11,32
93 St & Northern Blvd,40.7564,-73.87504,14,6,20
Sedgwick Ave & Hillman Ave,40.88224,-73.89136,6,15,21
Prospect Pl & Vanderbilt Ave,40.67767534,-73.96902144,25,0,25
71 St & 37 Ave,40.7488,-73.89451,4,18,22
St Marks Pl & 1 Ave,40.72779126,-73.98564945,40,25,65
Broadway & W 220 St,40.872412,-73.912807,7,11,18
Huron St & Franklin St,40.73266,-73.95826,33,0,33
Lewis Ave & Decatur St,40.6814598,-73.934903,1,13,14
E 3 St & 1 Ave,40.72467721,-73.98783413,39,10,49
Bedford Ave & Montgomery St,40.665816,-73.956934,7,19,26
W 145 St & Amsterdam Ave,40.825244,-73.947257,1,17,18
Park Ave & E 124 St,40.8045555,-73.9396861,31,2,33
Winthrop St & Nostrand Ave,40.65707,-73.95005,20,1,21
E 22 St & 2 Ave,40.73716919369882,-73.98122549057007,1,45,46
Boerum St & Broadway,40.70538077,-73.94976519,2,16,18
1 Ave & E 68 St,40.76500525,-73.95818491,9,51,60
Grand Army Plaza & Plaza St West,40.6729679,-73.97087984,37,0,37
Broadway & W 192 St,40.857994,-73.932173,15,6,21
34 St & 48 Ave,40.740821207823245,-73.93147185444832,7,16,23
Vernon Blvd & 10 St,40.7671863,-73.9373554,29,10,39
E 4 St & Ave B,40.723346832180155,-73.98265913128853,16,17,33
E 14 St & 1 Ave,40.73139303364151,-73.98286700248718,6,27,33
Pacific St & Sackman St,40.67522,-73.9061,11,8,19
31 Ave & 14 St,40.7682,-73.9322662,9,10,19
Monroe St & Patchen Ave,40.68814,-73.92693,4,13,17
Ditmars Blvd & 19 St,40.78145,-73.9183302,14,10,24
Edgecombe Ave & W 150 St,40.826881,-73.941427,3,11,14
Brunswick St,40.7241765,-74.0506564,14,6,20
Hoyt St & Warren St,40.6843549,-73.98901629,24,9,33
79 St & Roosevelt Ave,40.74718,-73.88675,1,20,21
Southern Blvd & Xavier Way,40.86149,-73.88103,8,22,30
Matthews Ct & Coney Island Ave,40.64235,-73.96951,16,4,20
31 Ave & Steinway St,40.7611488,-73.9170071,2,25,27
Bailey Ave & Sedgwick Ave,40.86571,-73.90857,6,14,20
Sterling St & Bedford Ave,40.6627059,-73.9569115,11,7,18
W 160 St & St Nicholas Ave,40.834468,-73.939865,3,23,26
Faile St & Garrison Ave,40.820578,-73.888271,4,11,15
Hanson Pl & Ashland Pl,40.68506807308177,-73.97790759801863,12,25,37
E 48 St & 3 Ave,40.7546011026,-73.971878855,5,67,72
33 St & Queens Blvd,40.7443653191867,-73.93172398209572,12,11,23
Leonard St & Boerum St,40.70583339,-73.94644578,11,11,22
E 6 St & Ave B,40.72453734,-73.98185424,25,64,89
100 St & Lewis Ave,40.73988,-73.86012,11,9,20
Anderson Ave & W 164 St,40.832057,-73.927421,1,17,18
48 St & 2 Ave,40.650176,-74.015606,15,1,16
W 20 St & 8 Ave,40.74345335,-74.00004031,34,42,76
Roebling St & N 4 St,40.71469,-73.95739,9,15,24
43 St & 23 Ave,40.769673,-73.906018,14,7,21
Emerson Pl & Myrtle Ave,40.69363137,-73.96223558,11,46,57
Henry St & W 9 St,40.6763744,-74.00324957,15,1,16
90 St & 32 Ave,40.75836,-73.87824,12,8,20
Eastern Pkwy & Schenectady Ave,40.66876,-73.93376,3,18,21
81 St & 24 Ave,40.76466,-73.88803,19,0,19
E 51 St & 2 Ave,40.755293,-73.967641,1,38,39
Ithaca St & Baxter Ave,40.74638,-73.88322,2,20,22
Central Park W & W 91 St,40.788664991278836,-73.96680057048798,15,31,46
Shea Rd & Boat Basin Pl,40.75777,-73.84887,10,0,10
Jersey & 6th St,40.72528910781132,-74.04557168483734,8,6,14
Fort Washington Ave & W 173 St,40.84522,-73.940493,2,19,21
Madison St & Clinton St,40.71269042,-73.98776323,27,10,37
37 Ave & 35 St,40.7531106,-73.9279917,10,12,22
28 St & 36 Ave,40.757186,-73.932719,7,22,29
N 12 St & Bedford Ave,40.72079821,-73.95484712,40,4,44
9 Ave & W 22 St,40.7454973,-74.00197139,19,41,60
9 St & 44 Rd,40.74966,-73.9521,29,4,33
St Marks Ave & Thomas S. Boyland St,40.67313,-73.91387,10,8,18
Lewis Ave & Greene Ave,40.68995,-73.9365,1,22,23
E 178 St & Monterey Ave,40.84749,-73.89464,6,14,20
Jerome Ave & E 198 St,40.87144520687118,-73.89289632439613,6,11,17
Monroe St & Classon Ave,40.6845683,-73.95881081,0,19,19
5 Ave & E 87 St,40.78232260730881,-73.95987510681152,32,3,35
Macon St & Lewis Ave,40.68282,-73.93488,1,18,19
Nelson Ave & W 172 St,40.843965,-73.920999,5,12,17
W 82 St & Central Park W,40.78275,-73.97137,20,14,34
3 Ave & E Tremont Ave,40.84649,-73.89616,8,15,23
E New York Ave & Troy Ave,40.66227,-73.93762,17,4,21
E 11 St & Ave B,40.72746420692392,-73.97950418293476,15,48,63
Grand Concourse & E 197 St,40.86945,-73.89148,3,16,19
99 St & 38 Ave,40.75055,-73.86725,0,27,27
Steinway St & Broadway,40.75905795418586,-73.91897544264793,4,25,29
E 2 St & Ave A,40.72307749068673,-73.98583620786667,23,38,61
Myrtle Ave & Linden St,40.69943,-73.91337,2,23,25
Nostrand Ave & Rutland Rd,40.6595,-73.95041,5,14,19
Van Cleef St & 108 St,40.74096,-73.85357,12,8,20
W 47 St & 10 Ave,40.76269882,-73.99301222,3,32,35
Atlantic Ave & Furman St,40.69165183,-73.9999786,30,1,31
28 Ave & 35 St,40.7671,-73.9169858,0,26,26
40 St & Queens Blvd,40.743540273428685,-73.92435193061829,3,17,20
1 Ave & E 38 St,40.746202,-73.971822,7,29,36
Prospect Pl & Howard Ave,40.67261,-73.91977,4,13,17
5 St & 51 Ave,40.7423737,-73.9566,15,6,21
Putnam Ave & Nostrand Ave,40.68402,-73.94977,5,11,16
Sands St Gate,40.699569,-73.979827,10,2,12
28 St & 41 Ave,40.751047,-73.93797,5,20,25
Boston Rd & Prospect Ave,40.833246,-73.896599,9,8,17
41 Ave & 67 St,40.74446,-73.89764,6,14,20
Roosevelt Ave & 104 St,40.74984,-73.86156,19,5,24
Boston Rd & E 167 St,40.828199,-73.903719,7,12,19
Kingsland Ave & Nassau Ave,40.72577,-73.94173,0,25,25
National St & 45 Ave,40.74582,-73.86433,10,11,21
Windsor Pl & 8 Ave,40.660906,-73.983074,15,5,20
South Waterfront Walkway - Sinatra Dr & 1 St,40.73698221818716,-74.02778059244156,4,25,29
63 St & Borden Ave,40.72655,-73.90321,13,4,17
Clark St & Henry St,40.69760127,-73.99344559,11,26,37
31 St & 21 Ave,40.77813,-73.90842,2,23,25
Grand Concourse & E 156 St,40.823429,-73.924689,1,16,17
W 37 St & 5 Ave,40.75038009,-73.98338988,1,56,57
3 Ave & E 169 St,40.832678,-73.905158,4,16,20
Old Broadway & W 133 St,40.818212,-73.955277,14,5,19
Lafayette Ave & Stuyvesant Ave,40.6919925157634,-73.9325501024723,8,14,22
DeKalb Ave & Bedford Ave,40.690894,-73.955195,16,5,21
Brooklyn Ave & Prospect Pl,40.67412,-73.94447,5,14,19
65 Pl & 53 Ave,40.73145,-73.90022,15,4,19
Kent Ave & Grand St,40.716425,-73.96594,39,1,40
Clinton St & Union St,40.6831164,-73.99785267,26,8,34
5 Ave & W 139 St,40.815484,-73.935856,8,8,16
Lexington Ave & E 36 St,40.747573958954796,-73.9788007736206,0,19,19
60 St & 37 Ave,40.74952,-73.90265,15,0,15
25 Ave & 85 St,40.76328,-73.88404,17,1,18
Pleasant Ave & E 116 St,40.79499,-73.93333,9,12,21
Metropolitan Ave & Vandervoort Ave,40.71429,-73.93323,21,3,24
Concourse Village East & E 158 St,40.823732,-73.919379,9,18,27
Palmetto St & Traffic Ave,40.70929,-73.89441,10,8,18
E 149 St & Jackson Ave,40.813135,-73.909235,3,16,19
W 40 St & 7 Ave,40.754818,-73.988154,1,43,44
Irving Ave & Jefferson St,40.70538,-73.92535,16,0,16
W 160 St & Riverside Dr,40.83719,-73.9466,1,24,25
E 51 St & Lexington Ave,40.75714758,-73.97207836,10,62,72
Lafayette St & Grand St,40.72028,-73.99879,68,0,68
City Hall - Washington St & 1 St,40.73736,-74.03097,15,4,19
E 138 St & 5 Ave,40.81449,-73.936153,11,9,20
Wyckoff St & 3 Ave,40.6827549,-73.98258555,5,10,15
Wallabout St & Kent Ave,40.6991049,-73.960633406,0,23,23
Caton Ave & E 7 St,40.647718,-73.973663,13,3,16
Grand Concourse & E Mosholu Pkwy S,40.877964,-73.8847550291,16,5,21
Sterling Pl & New York Ave,40.67234,-73.94763,0,24,24
Broadway & W 168 St,40.84089603193041,-73.93972098827362,0,26,26
E 10 St & 2 Ave,40.72970805644994,-73.9865979552269,27,11,38
E 12 St & 3 Ave,40.73223272,-73.98889957,12,56,68
E 77 St & 1 Ave,40.77095553869235,-73.95356208096926,5,44,49
Cauldwell Ave & E 158 St,40.81989,-73.908351,3,15,18
Decatur Ave & Oliver Pl,40.867,-73.8857764,17,2,19
Maiden Ln & Pearl St,40.70706456,-74.00731853,16,9,25
Thomas S. Boyland St & Macon St,40.68491,-73.91493,8,12,20
Leonard St & Nassau Ave,40.7239567849954,-73.94984364509583,21,15,36
Plaza St East & Flatbush Ave,40.673134,-73.969106,59,1,60
W Broadway & Watts St,40.72323,-74.00314,49,0,49
W 111 St & 5 Ave,40.797520781247556,-73.9489397406578,7,11,18
Lexington Ave & E 111 St,40.7954121,-73.9441232,20,9,29
8 Ave & W 31 St,40.7505853470215,-73.9946848154068,73,18,91
E 141 St & Jackson Ave,40.806896,-73.911837,9,9,18
Bushwick Ave & Harman St,40.69356,-73.92524,2,23,25
21 St & 23 Ave,40.778557,-73.919046,18,4,22
49 Ave & 21 St,40.74252,-73.948852,10,11,21
E 188 St & Hughes Ave,40.8561,-73.88625,14,6,20
Newton Rd & 44 St,40.7595701,-73.9142678,16,1,17
Melrose Ave & E 154 St,40.819609,-73.916071,14,5,19
7 Ave S & Bleecker St,40.73213896287381,-74.00363802909851,71,5,76
Summerfield St & Cypress Ave,40.69662,-73.90056,5,10,15
Broadway & Madison St,40.68822,-73.91966,13,11,24
E 169 St & Webster Ave,40.834015,-73.908863,14,6,20
Cypress Ave & George St,40.69812,-73.90271,4,14,18
Marion Ave & Mosholu Pkwy,40.8704956,-73.8818756582,13,4,17
W 51 St & 6 Ave,40.7606597,-73.98042047,4,77,81
Patchen Ave & Bainbridge St,40.68143,-73.92565,12,6,18
92 St & 35 Ave,40.7529,-73.87536,3,22,25
1 Ave & E 6 St,40.72633085971696,-73.98616880178452,61,30,91
11 St & 44 Rd,40.749207,-73.949373,20,7,27
9 Ave & W 39 St,40.756403523272496,-73.99410143494606,13,18,31
104 St & Northern Blvd,40.75755,-73.86454,11,10,21
Tyler Ave & Maurice Ave,40.73394,-73.90128,11,4,15
E New York Ave & Utica Ave,40.662686,-73.931755,10,11,21
11 Ave & Prospect Ave,40.65629,-73.977335,6,13,19
Central Park W & W 97 St,40.79249519495111,-73.96417066463071,34,17,51
Crescent Ave & Belmont Ave,40.85391,-73.8866,16,4,20
Bronx Shore Comfort Station,40.80046,-73.92404,8,10,18
Willoughby St & Fleet St,40.69196566,-73.9813018,11,46,57
Nassau Ave & Newell St,40.724812564400175,-73.94752621650696,13,33,46
Madison Ave & E 120 St,40.80295,-73.942954,17,8,25
W 148 St & Amsterdam Ave,40.827075,-73.945909,0,19,19
43 Ave & 111 St,40.74955,-73.85464,14,2,16
DeKalb Ave & Hudson Ave,40.689888,-73.981013,63,8,71
St Johns Pl & Utica Ave,40.6705,-73.9308,13,4,17
Verona Pl & Fulton St,40.6803560840434,-73.9476791024208,1,15,16
Smith St & 3 St,40.6787242,-73.99599099,20,0,20
34 Ave & 45 St,40.754795,-73.917014,4,16,20
5 St & 6 Ave,40.6704836,-73.98208968,13,5,18
Goble Pl & Macombs Rd,40.844075,-73.917256,15,2,17
W 186 St & St Nicholas Ave,40.852253,-73.931308,6,19,25
Albany Ave & Carroll St,40.6667,-73.93972,9,7,16
61 St & Borden Ave,40.72558,-73.90417,18,3,21
Metropolitan Ave & 65 Ln,40.71225,-73.89111,14,6,20
Jefferson Ave & Evergreen Ave,40.68989,-73.91458,5,9,14
E 72 St & Park Ave,40.77118287540658,-73.96409422159195,34,10,44
University Ave & Morton Pl,40.85118155499655,-73.91465058978447,12,8,20
Rogers Pl & E 165 St,40.82388366441761,-73.8974027708582,4,15,19
Southern Blvd & E 149 St,40.811892,-73.904192,22,1,23
St Johns Pl & Washington Ave,40.6737236,-73.9631611,23,5,28
Berry St & N 8 St,40.7190095,-73.95852515,22,2,24
College Ave & E 170 St,40.837576,-73.910489,7,17,24
Steinway St & Ditmars Blvd,40.772717,-73.906127,4,16,20
Amsterdam Ave & W 73 St,40.77966809007312,-73.98093044757842,19,33,52
Garfield Pl & 8 Ave,40.6711978,-73.97484126,5,18,23
W 133 St & 12 Ave,40.820003,-73.959089,12,5,17
E 163 St & Union Ave,40.822545,-73.901824,6,14,20
Caton Ave & Bedford Ave,40.65237,-73.95623,11,5,16
Shakespeare Ave & W 169 St,40.839312,-73.922423,5,9,14
7 Ave & Central Park South,40.7667405590595,-73.9790689945221,26,46,72
Carroll St & Utica Ave,40.66619,-73.93162,7,11,18
Thomas S. Boyland St & Fulton St,40.67854,-73.91367,0,24,24
Winthrop St & Albany Ave,40.6577,-73.9398,10,8,18
Laight St & Hudson St,40.72185379,-74.00771779,46,38,84
St James Pl & Oliver St,40.71307916,-73.99851193,41,2,43
50 St & Northern Blvd,40.753441,-73.912402,9,18,27
Degraw St & 3 Ave,40.67977,-73.9847,26,2,28
Ditmars Blvd & 73 St,40.76817,-73.896293,15,1,16
W 238 St & Tibbett Ave,40.88602,-73.90232,18,2,20
Ogden Ave & Merriam Ave,40.839142,-73.925961,6,11,17
23 Ave & 27 St,40.776165,-73.9153175,7,12,19
Lexington Ave & E 24 St,40.74025878,-73.98409214,2,74,76
Withers St & Kingsland Ave,40.71773,-73.94051,9,7,16
Flatbush Ave & Fenimore St,40.65798,-73.96051,17,3,20
30 Ave & 21 St,40.7703743,-73.9286078,5,9,14
E 25 St & 1 Ave,40.7381765,-73.97738662,2,29,31
Willis Ave & E 137 St,40.808384,-73.923604,14,4,18
Green St & McGuinness Blvd,40.73396,-73.95204,15,3,18
Bedford Ave & Maple St,40.66035,-73.95679,10,11,21
Bainbridge Ave & E 198 St,40.8684871,-73.8884559781,14,6,20
82 St & 30 Ave,40.76109,-73.88632,17,1,18
Ave A & E 14 St,40.73031071000895,-73.98047178983688,1,34,35
Carroll St & Rochester Ave,40.66598,-73.9284,10,10,20
Driggs Ave & N Henry St,40.72325,-73.94308,16,40,56
Washington Ave & E 163 St,40.824,-73.91089,1,14,15
W 106 St & Central Park W,40.7981856,-73.9605909006,16,34,50
Vernon Blvd & 31 Ave,40.7692475,-73.9354504,12,8,20
Adam Clayton Powell Blvd & W 130 St,40.812346,-73.946168,12,3,15
43 Ave & 47 St,40.7448062877224,-73.91728967428207,9,20,29
Vesey Pl & River Terrace,40.7153379,-74.01658354,44,4,48
Snyder Ave & Schenectady Ave,40.65,-73.93296,7,8,15
7 Ave & 40 St,40.648169,-74.000057,7,12,19
Woodside Ave & Roosevelt Ave,40.74549,-73.90605,14,0,14
Plaza Dr & W 170 St,40.840484,-73.917946,24,2,26
S 5 Pl & S 5 St,40.710451,-73.960876,28,10,38
1 Ave & E 118 St,40.797459,-73.934499,1,22,23
24 St & 38 Ave,40.756351,-73.936515,6,11,17
Broadway & Morris St,40.705945132708806,-74.01321887969969,40,20,60
Aqueduct Ave & W 190 St,40.8649213,-73.9024238,2,16,18
Cedar Ave & W Fordham Rd,40.86156,-73.91219,10,10,20
Grand Ave & Bergen St,40.678045,-73.962408,10,12,22
Marin Light Rail,40.71458403535893,-74.04281705617905,17,9,26
Prospect Park SW & 16 St,40.657265,-73.974165,21,3,24
Grand Ave & W 181 St,40.856302,-73.907302,3,11,14
E 133 St & Cypress Pl,40.80262,-73.9174,6,10,16
Louis Nine Blvd & Intervale Ave,40.831998,-73.892686,12,3,15
Stevens - River Ter & 6 St,40.74313282710551,-74.02698867022991,0,14,14
Fort Hamilton Pkwy & E 5 St,40.649037,-73.97673,18,1,19
Berkeley Pl & 7 Ave,40.675146838709786,-73.97523209452629,8,19,27
Queens Blvd & Broadway,40.73672,-73.87728,22,1,23
E 1 St & 1 Ave,40.72335597960796,-73.98864984512329,55,16,71
Carroll St & 6 Ave,40.6740886,-73.9787282,13,8,21
S 4 St & Roebling St,40.710709,-73.959724,7,30,37
West Farms Rd & Boone Ave,40.8301283948092,-73.88630211353302,13,6,19
Washington Ave & E 167 St,40.829896,-73.907618,6,10,16
Market St & Cherry St,40.71076228,-73.99400398,33,1,34
Duffield St & Willoughby St,40.69221589,-73.9842844,2,42,44
Franklin St & W Broadway,40.71911552,-74.00666661,27,3,30
W 54 St & 9 Ave,40.76604,-73.98737,0,43,43
Frederick Douglass Blvd & W 115 St,40.8038654,-73.9559308,8,23,31
Sedgwick Ave & W 231 St,40.87512,-73.90126,15,2,17
E 97 St & 3 Ave,40.7859201,-73.94860294,8,21,29
Gerard Ave & E 165 St,40.83173,-73.922394,12,6,18
Bay St & Court St,40.671409,-74.001328,25,1,26
9 Ave & W 219 St,40.871094,-73.911503,12,5,17
Cadman Plaza E & Red Cross Pl,40.69991755,-73.98971773,24,13,37
36 St & 3 Ave,40.655716,-74.006664,28,1,29
Wythe Ave & N 13 St,40.722767,-73.957021,43,0,43
11 St & 43 Ave,40.75177,-73.94821,21,6,27
Putnam Ave & Ralph Ave,40.68705,-73.92338,3,14,17
39 St & 47 Ave,40.74215636827728,-73.92662644386292,1,18,19
Grand Concourse & E 205 St,40.875531,-73.8863864831,7,10,17
Moffat St & Bushwick,40.68458,-73.90925,3,13,16
Schermerhorn St & Hoyt St,40.6886263,-73.9851911,12,24,36
Stagg St & Union Ave,40.70877084,-73.95095259,1,32,33
41 Ave & 80 St,40.74586,-73.88539,3,18,21
Park Ave & E 162 St,40.825716,-73.915585,6,10,16
Southern Blvd & E 142 St,40.807347437082,-73.90809774398804,2,20,22
Albemarle Rd & McDonald Ave,40.645074,-73.979681,2,17,19
Walton Ave & E 151 St,40.82090903827738,-73.92753845245076,20,6,26
Stanton St & Chrystie St,40.72229346,-73.99147535,38,7,45
Pike St & E Broadway,40.71406667,-73.99293911,32,0,32
Exchange Pl,40.71636596185077,-74.034343957901,17,11,28
E 54 St & 1 Ave,40.756265,-73.964179,0,34,34
South St & Pike St,40.70991806921533,-73.99161100387573,34,1,35
Riverside Dr & W 153 St,40.832164,-73.949702,4,16,20
Sterling Pl & Schenectady Ave,40.6716,-73.93378,1,19,20
Central Park W & W 68 St,40.7734066,-73.97782542,29,10,39
E Burnside Ave & Ryer Ave,40.850535,-73.901318,3,14,17
Waterloo Pl & Crotona Park East,40.839194,-73.888587,5,14,19
Giles Pl & Fort Independence St,40.87869,-73.89862,4,13,17
Jefferson Ave & Patchen Ave,40.68609,-73.92628,7,10,17
Douglass St & 3 Ave,40.6802133,-73.98432695,31,0,31
Clinton St & Newark St,40.73743,-74.03571,3,9,12
E 187 St & 3 Ave,40.85724,-73.8909,12,5,17
Hancock St & Wyckoff Ave,40.6972,-73.90674,4,14,18
Chauncey St & Howard Ave,40.68158,-73.91959,13,8,21
W 25 St & 6 Ave,40.74395411,-73.99144871,3,45,48
Central Ave & Decatur St,40.6882,-73.90798,5,19,24
Beverley Rd & E 49 St,40.64621,-73.93067,20,0,20
Grand Concourse & E 196 St,40.86767,-73.89286,0,20,20
Murray St & West St,40.71503,-74.01246,43,17,60
E 156 St & Courtlandt Ave,40.82123860172,-73.9173299074173,7,13,20
86 St & 35 Ave,40.7523,-73.88093,9,9,18
W Tremont Ave & Grand Ave,40.850036,-73.912785,11,10,21
76 St & 45 Ave,40.7411,-73.88837,5,12,17
Crescent St & 35 Ave,40.7596276,-73.9321455,8,17,25
99 St & Astoria Blvd,40.76196,-73.87042,17,5,22
Van Vorst Park,40.71848892,-74.047726625,14,4,18
Hancock St & Bedford Ave,40.68216564,-73.95399026,2,24,26
W 54 St & 6 Ave,40.761865,-73.977242,11,52,63
Division Ave & Marcy Ave,40.70708701,-73.95796783,16,15,31
87 St & 30 Ave,40.76156,-73.88167,10,10,20
84 St & Roosevelt Ave,40.74797,-73.88204,3,24,27
6 Ave & W 33 St,40.74901271,-73.98848395,41,30,71
President St & 4 Ave,40.676757,-73.983262,23,1,24
Barclay St & Church St,40.71291224,-74.01020234,29,7,36
55 St & 7 Ave,40.639673,-74.008957,10,12,22
82 St & Broadway,40.74281,-73.88296,26,3,29
Park Ave & E 179 St,40.85014,-73.89818,20,0,20
Prospect Park West & 8 St,40.66514681533792,-73.97637605667114,10,11,21
Lincoln Pl & Nostrand Ave,40.67077,-73.9507,4,17,21
E 144 St & Brook Ave,40.811675,-73.917037,2,13,15
Bridge St & Front St,40.702969341552716,-73.98469090461731,40,3,43
7 St & 5 Ave,40.6704922,-73.98541675,17,4,21
14 St & 5 Ave,40.666287,-73.98895053,5,12,17
Eastern Pkwy & Ralph Ave,40.66852,-73.92284,13,7,20
E 44 St & Lexington Ave,40.752643,-73.974996,21,23,44
10 St & 7 Ave,40.6662078,-73.98199886,10,8,18
31 St & Hoyt Ave N,40.7711528,-73.9170074,4,27,31
Brook Ave & E 148 St,40.814383,-73.915368,5,14,19
W 135 St & Lenox Terrace Pl,40.813619,-73.939336,13,14,27
E 95 St & 3 Ave,40.7849032,-73.950503,25,4,29
Webster Ave & Ford St,40.85556,-73.89615,18,1,19
Central Ave & Weirfield St,40.69055,-73.91181,6,13,19
E 68 St & 3 Ave,40.76712840349542,-73.96224617958069,25,7,32
Centre St & Worth St,40.71494807,-74.00234482,63,53,116
Riverside Dr & W 78 St,40.78414472,-73.98362492,14,58,72
12 Ave & 36 St,40.643546,-73.986418,10,8,18
Webb Ave & W 190 St,40.8660052,-73.904254892,12,8,20
75 St & Northern Blvd,40.75473,-73.8918,5,11,16
27 Ave & 9 St,40.7739825,-73.9309134,10,26,36
Commerce St & Van Brunt St,40.6812117,-74.00860912,16,0,16
Adams St & 12 St,40.751889392240685,-74.03329162748534,10,4,14
2 Ave & E 72 St,40.7687620293096,-73.95840793848038,10,40,50
Riverside Dr & Broadway,40.865364,-73.92791,17,5,22
Union Ave & Wallabout St,40.70029511,-73.95032283,14,15,29
Riverside Dr & W 104 St,40.8013434,-73.9711457439,5,41,46
5 Ave & E 78 St,40.77632142182271,-73.96427392959595,29,16,45
Underhill Ave & Pacific St,40.6804836,-73.9646795,18,6,24
3 Ave & E 100 St,40.7877214,-73.94728331,10,15,25
Pitt St & Stanton St,40.71926081,-73.98178024,4,8,12
60 Ave & Otis Ave,40.73715,-73.85614,17,2,19
47 Ave & 31 St,40.743,-73.93561,13,14,27
Pierrepont St & Monroe Pl,40.69535693320225,-73.99344027042389,2,18,20
E 30 St & Park Ave S,40.74444921,-73.98303529,16,48,64
Amory Ct & Metropolitan Ave,40.71301,-73.90968,9,11,20
Plaza St West & Flatbush Ave,40.6750207,-73.97111473,29,4,33
Seaman Ave & Isham St,40.869898661940454,-73.92076313495636,18,4,22
Audubon Ave & Fort George Ave,40.85715781391904,-73.92717361450195,8,13,21
Congress St & Clinton St,40.68825516598005,-73.99545192718506,29,8,37
Albany Ave & Fulton St,40.6800105,-73.938475,9,15,24
E 160 St & Tinton Ave,40.820302,-73.903944,3,18,21
103 St & Martense Ave,40.74046,-73.8565,12,5,17
21 St & 43 Ave,40.75052534,-73.94594845,14,12,26
31 St & Thomson Ave,40.74469738,-73.93540375,25,22,47
31 Ave & 61 St,40.757525,-73.901614,14,3,17
Hoboken Terminal - Hudson St & Hudson Pl,40.73593758446329,-74.03030455112457,21,3,24
Broadway & W 133 St,40.8190344,-73.956156,5,13,18
Bleecker St & Crosby St,40.72615604980408,-73.99510189890862,57,4,61
Adam Clayton Powell Blvd & W 123 St,40.8078316,-73.949373,24,4,28
Greene Ave & Throop Ave,40.6894932,-73.942061,2,15,17
77 St & 31 Ave,40.75886,-73.89081,14,4,18
Macombs Pl & W 152 St,40.826406,-73.937948,4,24,28
W 120 St & Claremont Ave,40.8109494,-73.9634,9,24,33
Kingston Ave & Park Pl,40.67308,-73.94191,1,14,15
Jersey & 3rd,40.72333158646436,-74.04595255851744,9,2,11
Frost St & Meeker Ave,40.71766197083994,-73.94880026578903,7,31,38
E 47 St & Park Ave,40.75510267,-73.97498696,15,92,107
Mott St & Prince St,40.72317958,-73.99480012,25,6,31
Paulus Hook,40.7141454,-74.0335519,10,2,12
55 Ave & Center Blvd,40.740288,-73.960697,5,22,27
Perry St & Greenwich Ave,40.735918,-74.000939,49,3,52
E 75 St & 3 Ave,40.77112927,-73.95772297,5,33,38
Jackson Mill Rd & 93 St,40.75874,-73.87535,7,13,20
48 St & 37 Ave,40.751555,-73.915026,5,20,25
88 St & Astoria Blvd,40.76424,-73.8812,16,1,17
W 12 St & Hudson St,40.73752993301071,-74.00558933615685,26,14,40
Grand St & Greene St,40.72170005235607,-74.00238141417502,33,9,42
Heights Elevator,40.748715945380226,-74.04044330120087,2,16,18
Bond St & Fulton St,40.6896218879,-73.9830426872,28,10,38
E 13 St & Ave A,40.72966729392978,-73.98067966103554,10,76,86
College Ave & E 169 St,40.835122799036405,-73.91196817159653,5,14,19
5 Ave & E 63 St,40.766368,-73.971518,4,43,47
Eastern Pkwy & Kingston Ave,40.66959,-73.94237,7,22,29
Central Park North & Adam Clayton Powell Blvd,40.799484,-73.955613,14,18,32
75 St & 35 Ave,40.75091,-73.89111,13,12,25
Amsterdam Ave & W 125 St,40.813358,-73.956461,35,2,37
Marble Hill Ave & W 227 St,40.87655,-73.90941,13,0,13
Linden St & Knickerbocker Ave,40.69714,-73.91566,7,11,18
Broadway & W 41 St,40.75513557,-73.98658032,13,38,51
20 Ave & Shore Blvd,40.785994,-73.915098,3,16,19
Sterling Pl & Ralph Ave,40.67095,-73.92222,1,16,17
W 116 St & Amsterdam Ave,40.8067581,-73.9607082,2,39,41
E 68 St & Madison Ave,40.7691572,-73.96703464,11,47,58
17 St & 5 Ave,40.663493,-73.991007,13,4,17
St Nicholas Ave & W 157 St,40.832314,-73.94102,1,13,14
Broadway & E 19 St,40.73829,-73.99006,43,52,95
Aqueduct Ave & North St,40.8604787,-73.9057169936,4,13,17
3 Ave & 17 St,40.666168,-73.995549,17,2,19
Bridge St & York St,40.70133448066992,-73.98471236228943,49,4,53
E 48 St & Tilden Ave,40.64795,-73.93182,14,14,28
Halsey St & Tompkins Ave,40.6823687,-73.944118,12,8,20
85 St & Northern Blvd,40.75601,-73.88266,5,13,18
E 189 St & Bathgate Ave,40.85859,-73.88821,17,1,18
Wythe Ave & Metropolitan Ave,40.716887,-73.963198,52,1,53
10 Ave & W 215 St,40.86932465640094,-73.91519755125046,15,4,19
Lee Ave & Taylor St,40.706732,-73.961241,17,4,21
2 Ave & E 96 St,40.7839636,-73.9471673,39,0,39
Columbia Heights & Cranberry St,40.70037867,-73.99548059,22,13,35
Bergen St & Smith St,40.6867443,-73.99063168,35,5,40
44 St & 2 Ave,40.652502,-74.013587,16,2,18
E 32 St & Park Ave,40.7457121,-73.98194829,3,46,49
West Drive & Prospect Park West,40.6610633719006,-73.97945255041122,12,7,19
W 41 St & 8 Ave,40.75640548,-73.9900262,60,43,103
Nagle Ave & Thayer St,40.861382,-73.925591,27,3,30
Broad St & Bridge St,40.70365182,-74.01167797,14,32,46
Bergen Ave,40.722103786686034,-74.07145500183105,3,7,10
E 182 St & Belmont Ave,40.85089,-73.88793,3,19,22
Monitor St & Meeker Ave,40.721226,-73.941845,8,12,20
25 Ave & 41 St,40.767666,-73.910963,0,21,21
Claflin Ave & Reservoir Ave,40.87398,-73.89943,17,2,19
Roosevelt Island Tramway,40.757284,-73.9536,25,10,35
McGinley Square,40.7253399253558,-74.06762212514877,2,20,22
59 St & 41 Ave,40.744577,-73.905986,17,0,17
4 Ave & 9 St,40.6705135,-73.98876585,26,2,28
Morris Ave & E Burnside Ave,40.85322,-73.90546,15,4,19
55 St & 5 Ave,40.642408,-74.013318,4,24,28
Liberty St & Nassau St,40.70858894,-74.00935482,2,43,45
30 Ave & 70 St,40.76013,-73.89741,12,4,16
Wyckoff Ave & Gates Ave,40.699871408829885,-73.91171872615814,22,12,34
President St & Henry St,40.6828003,-73.99990419,21,3,24
Division St & Bowery,40.71419,-73.99673,34,4,38
57 Ave & 98 Pl,40.73802,-73.86103,16,9,25
Bank St & Hudson St,40.73652889,-74.00618026,15,10,25
Clinton St & 7 St,40.74542,-74.03332,4,14,18
Corona Ave & 111 St,40.7408,-73.84978,19,2,21
Bushwick Ave & Powers St,40.71247661,-73.94100005,11,21,32
Chauncey St & Stuyvesant Ave,40.68012,-73.93168,9,16,25
41 Ave & 77 St,40.74557,-73.8882,9,12,21
Morningside Dr & Amsterdam Ave,40.81028506306003,-73.95736455917358,11,18,29
Kane St & Clinton St,40.6861758,-73.99645295,23,3,26
Centre St & Chambers St,40.71273266,-74.0046073,6,49,55
Fulton Ave & St Paul's Pl,40.83545,-73.90153,3,12,15
Clermont Ave & Park Ave,40.69573398,-73.97129668,6,9,15
91 St & 23 Ave,40.76768,-73.87899,21,1,22
Audubon Ave & W 192 St,40.85589030603889,-73.92708241939545,1,17,18
Queens Blvd & Albion Ave,40.73856,-73.88553,14,6,20
34 Ave & Junction Blvd,40.75502,-73.87285,12,9,21
Lefferts Ave & Schenectady Ave,40.66343,-73.93472,22,5,27
Nassau St & Navy St,40.69839895,-73.98068914,49,3,52
14 St & 7 Ave,40.663779,-73.98396846,13,0,13
Marcus Garvey Blvd & Macon St,40.682601,-73.938037,1,14,15
St Nicholas Ave & W 137 St,40.818477,-73.947568,9,12,21
Crotona Park East & E 173 St,40.837037,-73.890413,1,15,16
34 St & 35 Ave,40.7569332,-73.9262231,11,7,18
Brooklyn Ave & Snyder Ave,40.64915,-73.94368,13,8,21
E 40 St & 5 Ave,40.752062307,-73.9816324043,20,73,93
37 Ave & 63 St,40.74893,-73.89981,7,13,20
4 St & Grand St,40.7422579775645,-74.03511106967926,9,9,18
Harlem River Dr & W 155 St,40.830476,-73.939929,13,5,18
W 43 St & 10 Ave,40.76009437,-73.99461843,7,99,106
50 St & Barnett Ave,40.750097682094825,-73.91349703073502,4,16,20
W 52 St & 11 Ave,40.76727216,-73.99392888,7,39,46
6 St & Grand St,40.744397833095604,-74.03450086712837,5,11,16
4 Ave & 17 St,40.665507,-73.993037,19,2,21
Fort Hamilton Pkwy & E 2 St,40.648005,-73.979342,16,0,16
Montrose Ave & Bushwick Ave,40.70767788,-73.94016171,12,28,40
Montague St & Clinton St,40.6942715,-73.9923272,7,41,48
Willoughby Ave & Myrtle Ave,40.69757,-73.93098,5,12,17
Wadsworth Ave & W 175 St,40.846052,-73.937648,8,11,19
Sedgwick Ave & Hall of Fame Terrace,40.859532,-73.913303,1,16,17
98 St & 25 Ave,40.76454,-73.87171,16,2,18
Grand St & 14 St,40.75409,-74.0316,2,16,18
Park Ave & E 41 St,40.751581,-73.97791,43,62,105
Jerome Ave & E 181 St,40.855653,-73.905528,9,7,16
MacDonough St & Malcolm X Blvd,40.68273,-73.92926,13,7,20
Kent Ave & Division Ave,40.706563674670925,-73.9683187007904,21,19,40
Bailey Ave & W 234 St,40.88066,-73.90076,18,1,19
58 St & Pier 4,40.646475,-74.026081,15,10,25
W 51 St & 7 Ave,40.76167,-73.98256,3,71,74
Rockaway Ave & Bainbridge St,40.68319988172761,-73.91166642308235,9,10,19
Benham St & Roosevelt Ave,40.74841,-73.8751,0,24,24
Naples Terrace & Godwin Terrace,40.87995,-73.90536,21,0,21
Cherry St,40.71219906,-73.97948148,11,23,34
73 St & 25 Ave,40.76205,-73.895,15,3,18
Lexington Ave & Classon Ave,40.68676793,-73.95928168,2,13,15
2 Ave & E 31 St,40.74299,-73.97711,3,76,79
Broadway & W 38 St,40.7529728216068,-73.98734897375107,16,51,67
Bainbridge Ave & E 193 St,40.86415477605928,-73.892452880543,17,9,26
Norfolk St & Broome St,40.7172274,-73.98802084,43,10,53
34 Ave & 21 St,40.7628138,-73.9342862,11,12,23
Central Park W & W 76 St,40.77896784,-73.97374737,22,9,31
Park Pl & Thomas S. Boyland St,40.67154,-73.91433,13,10,23
Coffey St & Ferris St,40.67818387977647,-74.0170168876648,20,0,20
100 St & Humphreys St,40.76574,-73.87012,19,0,19
8 St & Astoria Blvd,40.7725996921817,-73.93266275525093,16,0,16
Jackson Mill Rd & 24 Ave,40.76619,-73.87561,13,8,21
Nostrand Ave & Myrtle Ave,40.69527008,-73.95238108,11,11,22
Jerome Ave & Ogden Ave,40.829797,-73.931015,13,7,20
Walton Ave & E 171 St,40.840683,-73.915073,2,14,16
Van Brunt St & Van Dyke St,40.6758329439129,-74.01472628116608,18,0,18
7 Ave & Park Pl,40.6776147,-73.97324283,18,3,21
25 Ave & 96 St,40.76447,-73.87369,18,0,18
Grand Concourse & E 161 St,40.82713380423556,-73.9227358996868,6,17,23
W 37 St & 10 Ave,40.75660359,-73.9979009,1,35,36
St James Ave & 51 Ave,40.73813,-73.88104,13,6,19
Lexington Ave & E 120 St,40.8013066,-73.9398167,12,11,23
Washington Pl & 6 Ave,40.73224119,-74.00026394,66,6,72
E 155 St & Courtlandt Ave,40.82057,-73.917579,8,9,17
Lenox Ave & W 130 St,40.8107922,-73.9430681,12,10,22
Water St & Fletcher St,40.706410755236135,-74.00559738278389,67,5,72
W 163 St & Riverside Dr,40.839278,-73.945446,6,11,17
Rogers Ave & Lincoln Rd,40.66127,-73.95352,8,11,19
Kingston Ave & Herkimer St,40.67890679,-73.94142771,0,7,7
Broadway & W 58 St,40.76695317,-73.98169333,3,72,75
11 Ave & W 41 St,40.76030096,-73.99884222,8,43,51
35 St & 23 Ave,40.77301508291382,-73.91119033098221,2,23,25
Freeman St & Southern Blvd,40.830051,-73.892103,10,11,21
Underhill Ave & Lincoln Pl,40.6740123,-73.9671457,20,4,24
Lexington Ave & E 127 St,40.805726,-73.936322,17,4,21
S 2 St & Kent Ave,40.714731,-73.966612,44,0,44
Seaman Ave & Beak St,40.867505,-73.926363,8,11,19
E 97 St & Madison Ave,40.787801,-73.953559,21,19,40
Audubon Ave & W 179 St,40.847305,-73.933291,20,2,22
Maple St & Albany Ave,40.66155,-73.93974,16,2,18
Rugby Rd & Albemarle Rd,40.64672,-73.96637,14,3,17
Carlton Ave & Greene Ave,40.685957,-73.971468,11,11,22
Cypress Ave & St Felix Ave,40.69559,-73.89927,5,15,20
Bleecker St & Forest Ave,40.7107,-73.90525,3,14,17
Stanton St & Norfolk St,40.720747,-73.986274,38,6,44
Flushing Ave & Vanderbilt Ave,40.697950315695444,-73.97077560424805,3,16,19
Jackson Square,40.71113,-74.0789,4,12,16
W 15 St & 7 Ave,40.73935542,-73.99931783,39,37,76
48 Ave & 37 St,40.74034668087185,-73.92886072397232,2,15,17
Great Jones St,40.72743423,-73.99379025,17,0,17
E 47 St & 2 Ave,40.75323098,-73.97032517,0,99,99
Ocean Ave & Tennis Ct,40.64873,-73.96084,11,11,22
W 42 St & 8 Ave,40.7575699,-73.99098507,13,22,35
2 Ave & 36 St,40.65708866668485,-74.00870203971863,41,0,41
W 44 St & 5 Ave,40.75500254,-73.98014437,29,32,61
99 St & 50 Ave,40.74278,-73.86226,6,13,19
W 43 St & 6 Ave,40.75527307,-73.98316936,15,42,57
48 St & 50 Ave,40.73737,-73.91803,3,12,15
Eastern Pkwy & Franklin Ave (SW Corner),40.670529,-73.958222,5,23,28
39 Ave & 45 St,40.749478221834764,-73.91826465725897,7,10,17
34 St & 5 Ave,40.654098,-74.001131,19,0,19
E 4 St & 2 Ave,40.7262807,-73.98978041,31,40,71
W Tremont Ave & Montgomery Ave,40.851788,-73.916418,1,18,19
8 Ave & W 49 St,40.76171227910671,-73.98655101656914,4,53,57
W 63 St & Broadway,40.77163851,-73.98261428,8,21,29
Madison St & 1 St,40.73879,-74.0393,4,13,17
Amsterdam Ave & W 162 St,40.83618,-73.939789,9,14,23
27 St & Hunter St,40.7485,-73.941275,11,21,32
Madison Ave & E 51 St,40.75863,-73.97513,20,22,42
Franklin Ave & Myrtle Ave,40.694546087246025,-73.95801365375519,14,8,22
Halsey St & Ralph Ave,40.68494,-73.92299,11,6,17
34 Ave & 71 St,40.75257,-73.89538,7,13,20
W 54 St & 11 Ave,40.768333,-73.992573,6,52,58
Union Ave & E 169 St,40.82995,-73.898802,6,12,18
Pacific St & Nostrand Ave,40.6776,-73.94963,12,10,22
Newport Pkwy,40.7287448,-74.0321082,2,10,12
Rivington St & Ridge St,40.71850211,-73.98329859,23,30,53
Stuyvesant Ave & Hart St,40.69465,-73.9343,8,15,23
43 St & Skillman Ave,40.74692675687384,-73.9208248257637,4,14,18
W 24 St & 7 Ave,40.74487634,-73.99529885,6,69,75
E 132 St & Madison Ave,40.810224,-73.937195,5,13,18
44 St & Greenpoint Ave,40.741119944681465,-73.92103672027588,11,16,27
31 Ave & 57 St,40.757357,-73.904726,6,15,21
E 53 St & Lexington Ave,40.75828065,-73.97069431,0,44,44
Duane St & Hudson St,40.71703,-74.00925,40,0,40
E Tremont Ave & E 176 St,40.847798,-73.901883,8,10,18
E 102 St & Park Ave,40.7904828,-73.95033068,25,7,32
Henry St & Bay St,40.6725058,-74.00494695,18,0,18
Crotona Ave & E 183 St,40.85157,-73.88475,14,9,23
Schenectady Ave & Pacific St,40.67686,-73.93327,7,12,19
E 56 St & Madison Ave,40.761573,-73.972628,12,16,28
W 155 St & Frederick Douglass Blvd,40.82923,-73.936996,25,6,31
Icahn Stadium Plaza,40.79322,-73.92396,10,6,16
Monroe St & 11 St,40.7501091128573,-74.036636745998,14,6,20
Greenwich St & W Houston St,40.728846,-74.008591,75,3,78
Columbia St & Rivington St,40.71739973,-73.98016555,12,26,38
DeKalb Ave & S Portland Ave,40.68967018552252,-73.97527355121376,14,6,20
Catherine St & Monroe St,40.71117444,-73.99682619,33,0,33
Cliff St & Fulton St,40.70838,-74.00495,8,54,62
Fairmount Ave,40.72572613742557,-74.07195925712585,2,14,16
Suffolk St & Stanton St,40.72066442,-73.98517977,30,44,74
E Mosholu Pkwy & Van Cortlandt Ave E,40.87656,-73.88366,18,3,21
E 147 St & Bergen Ave,40.814673,-73.91839,7,14,21
E 138 St & Grand Concourse,40.813224,-73.930605,1,14,15
46 St & 6 Ave,40.645921,-74.005708,4,14,18
St Ann's Ave & E 144 St,40.811112,-73.914932,8,10,18
31 St & Northern Blvd,40.75186951421875,-73.93349289894103,1,34,35
Riverside Dr & W 91 St,40.79313480986663,-73.97700369358063,27,25,52
Christopher St & Greenwich St,40.73291553,-74.00711384,61,8,69
Washington Pl & Greene St,40.72980619180496,-73.99546380915461,39,2,41
Franklin Ave & E 169 St,40.83171,-73.90208,0,14,14
E 170 St & Clay Ave,40.837213,-73.908345,1,17,18
Gerard Ave & E 146 St,40.817755,-73.92965,8,11,19
Dixon Mills,40.721630142638354,-74.04996782541275,13,3,16
5 Ave & 3 St,40.6728155,-73.98352355,26,2,28
Woodward Ave & Harman St,40.70793,-73.91092,1,18,19
Grove St & Fresh Pond Rd,40.71032,-73.89955,5,7,12
N 5 St & Wythe Ave,40.718389,-73.961501,23,11,34
Columbia St & W 9 St,40.6769993,-74.00647134,20,0,20
Columbia St & Degraw St,40.6859296,-74.00242364,14,4,18
Clay Ave & Claremont Pkwy,40.83999,-73.90549,18,0,18
Madison Ave & E 99 St,40.78948541553215,-73.95242929458618,29,2,31
Washington St & Gansevoort St,40.739323,-74.008119,41,7,48
St Marks Pl & 2 Ave,40.7284186,-73.98713956,56,10,66
Lincoln Pl & Classon Ave,40.6721683,-73.9609,12,7,19
Keegan Rd & 2 Ave,40.64243139706092,-74.0255355834961,28,7,35
Lexington Ave & E 26 St,40.741459,-73.983293,1,79,80
Broadway & W 185 St,40.852538,-73.93441,10,11,21
Lenox Ave & W 133 St,40.81296,-73.941878,12,12,24
Bergen St & Troy Ave,40.67524,-73.93596,3,17,20
Atlantic Ave & Fort Greene Pl,40.68382604,-73.97632328,19,42,61
E 128 St & 3 Ave,40.805631,-73.934077,11,1,12
St Nicholas Ave & W 134 St,40.816234,-73.948222,5,14,19
E 106 St & Madison Ave,40.7934337,-73.94945003,18,1,19
Lafayette Park,40.71346382669195,-74.06285852193832,11,2,13
Lincoln Ave & E 134 St,40.808484,-73.928803,0,16,16
Intervale Ave & Kelly St,40.827301,-73.896372,13,7,20
W 30 St & 8 Ave,40.74965268472847,-73.9952078461647,38,25,63
3 Ave & E 71 St,40.76879,-73.9614,7,34,41
53 St & 4 Ave,40.644862,-74.014531,8,14,22
10 Ave & W 28 St,40.75066386,-74.00176802,8,40,48
Goulden Ave & Bedford Park Blvd,40.87387,-73.89533,8,7,15
Bushwick Ave & Dekalb Ave,40.69502,-73.92825,2,27,29
West Thames St,40.70834698,-74.01713445,51,13,64
Allen St & Stanton St,40.722055,-73.989111,34,6,40
W 21 St & 6 Ave,40.74173969,-73.99415556,3,65,68
E 63 St & 3 Ave,40.763954,-73.9646,6,50,56
Grand Concourse & E 192 St,40.86448,-73.89522,1,19,20
Skillman Ave & 43 Ave,40.74653761978055,-73.93215849995613,9,8,17
Ogden Ave & W 164 St,40.832812,-73.929372,12,7,19
30 Ave & 80 St,40.76109,-73.88838,17,2,19
E 14 St & Ave B,40.72938685,-73.97772429,3,36,39
34 Ave & 31 St,40.759604471387945,-73.92714411020279,8,7,15
Jefferson St & Cypress Ave,40.70907,-73.92157,16,8,24
93 St & Roosevelt Ave,40.74888,-73.87368,0,24,24
E 5 St & Ave A,40.72479007746337,-73.98430064320564,24,14,38
111 St & 53 Ave,40.74336,-73.85129,14,11,25
Irving Ave & Halsey St,40.69467,-73.90663,4,14,18
Intervale Ave & Westchester Ave,40.821967,-73.896752,23,2,25
Gansevoort St & Hudson St,40.73937600789778,-74.00520807425661,109,7,116
34 Ave & 113 St,40.75696,-73.85612,16,4,20
45 Ave & 21 St,40.74737075646803,-73.94777297973631,9,11,20
Onderdonk Ave & Dekalb Ave,40.70863,-73.91497,9,6,15
W 168 St & Fort Washington Ave,40.84210236102173,-73.9422395825386,3,38,41
Center Blvd & 51 Ave,40.743366080270214,-73.95960688591003,18,5,23
Myrtle Ave & Marcy Ave,40.69539817,-73.94954908,8,13,21
E 167 St & Clay Ave,40.83094,-73.91125,23,2,25
79 St & 37 Ave,40.74937,-73.88714,9,11,20
Reade St & Broadway,40.71450451,-74.00562789,14,45,59
Crotona Ave & E 179 St,40.84666,-73.88991,6,12,18
Nevins St & Schermerhorn St,40.68737247650719,-73.98176059126854,6,17,23
Menahan St & Seneca Ave,40.70461,-73.91054,2,12,14
Park Ave & E Tremont Ave,40.84731,-73.89981,23,0,23
60 St & 60 Rd,40.71592232709503,-73.90601366758347,7,9,16
Adam Clayton Powell Blvd & W 151 St,40.825289,-73.936232,6,10,16
Allen St & Hester St,40.71606,-73.99191,109,4,113
Carlton Ave & Dean St,40.6809741,-73.9710097,18,3,21
Lincoln Rd & Ocean Ave,40.6605,-73.9626,16,4,20
Fresh Pond Rd & Eliot Ave,40.71442,-73.90097,5,14,19
Broadway & Van Cortlandt Park S,40.8863,-73.8997,31,0,31
E 98 St & Park Ave,40.78813,-73.95206,9,13,22
Lincoln Park,40.7246050998869,-74.07840594649315,4,11,15
Stanhope St & Fairview Ave,40.70998,-73.91116,13,2,15
Westchester Ave & Longwood Ave,40.819701,-73.901311,2,17,19
Dean St & Hoyt St,40.6864442,-73.98759104,66,6,72
Pearl St & York St,40.70140463410644,-73.98768022656441,50,0,50
W 34 St & Hudson Blvd E,40.75516719072139,-74.00059908628464,10,45,55
W 48 St &  Rockefeller Plaza,40.75776935448309,-73.97929430007935,24,31,55
E 3 St & Church Ave,40.643817,-73.977433,3,16,19
6 Ave & Canal St,40.72243797,-74.00566443,30,40,70
72 St & 41 Ave,40.7448,-73.89377,2,24,26
Willoughby St & Ashland Pl,40.69178,-73.97877,19,11,30
4 St & River St,40.7408139,-74.0274062,1,10,11
Goulden Ave & W 197 St,40.87156,-73.89714,11,8,19
34 Ave & 89 St,40.75437,-73.87833,3,22,25
56 St & Arnold Ave,40.71484,-73.909,8,13,21
55 Ave & 97 Pl,40.73892,-73.86367,8,8,16
43 St & 37 Ave,40.750181,-73.919998,1,20,21
34 Ave & 38 St,40.75717,-73.92175,19,7,26
Greene St & Prince St,40.72511734422387,-73.99930492043495,40,0,40
Grand Concourse & E 184 St,40.85941,-73.8985,10,10,20
29 St & 5 Ave,40.656986,-73.998194,9,1,10
12 Ave & W 125 St,40.818299,-73.960405,26,7,33
E 85 St & 3 Ave,40.77801203,-73.95407149,22,14,36
St Nicholas Ave & W 126 St,40.8114323,-73.9518776,28,4,32
Sedgwick Ave & Giles Pl,40.88111,-73.8965,4,15,19
9 St HBLR - Jackson St & 8 St,40.74790720968899,-74.03841152787209,1,17,18
St Marks Pl & 4 Ave,40.68197,-73.98034,4,16,20
Fulton St & Waverly Ave,40.683238654603414,-73.96599590778351,5,24,29
Jerome Ave & E 164 St,40.831444,-73.926226,20,1,21
Bayard St & Baxter St,40.71602118,-73.99974372,33,3,36
7 Ave & 41 St,40.647379,-74.000911,4,17,21
Broadway & W 122 St,40.8120562,-73.9612547,8,16,24
Cambridge Pl & Gates Ave,40.68488,-73.96304,1,15,16
Adam Clayton Powell Blvd & W 138 St,40.81695971032464,-73.9422959089279,0,18,18
99 St & 32 Ave,40.75896,-73.86976,16,4,20
Decatur St & Saratoga Ave,40.68332,-73.91711,4,13,17
Lefferts Ave & Albany Ave,40.66288,-73.94019,16,5,21
4 Ave & 3 St,40.673746,-73.985649,33,6,39
W 84 St & Amsterdam Ave,40.78621,-73.9756,13,42,55
University Ave & W 168 St,40.838706,-73.927034,12,5,17
Beck St & Leggett Ave,40.815077,-73.899939,10,6,16
31 Pl & Hunters Point Ave,40.74021356884924,-73.93537044525146,6,12,18
3 Ave & Franklin Ave,40.82696,-73.907451,6,11,17
E Tremont Ave & Jerome Ave,40.851747,-73.908964,9,9,18
Cabrini Blvd & W 177 St,40.848282,-73.941343,4,19,23
Flatbush Ave & Eastern Pkwy,40.668757,-73.966438,22,1,23
E 11 St & 1 Ave,40.72953837,-73.98426726,34,17,51
Hope St & Union Ave,40.71167351,-73.95141312,8,13,21
Lawrence St & Willoughby St,40.69236178,-73.98631746,20,11,31
Bergen Ave & Stegman St,40.70657545063453,-74.0867006778717,15,4,19
W 35 St & 8 Ave,40.752762088742045,-73.99280458705107,19,25,44
Prospect Ave & Greenwood Ave,40.651745,-73.975988,9,8,17
Morris Ave & E 153 St,40.820036,-73.921411,13,6,19
India St Pier,40.731734785883454,-73.9612390102593,36,18,54
Adam Clayton Powell Blvd & W 141 St,40.819241,-73.941057,6,14,20
Dock St & Front St,40.702709,-73.99253,26,0,26
E 20 St & Park Ave,40.73827428,-73.98751968,8,17,25
Pearl St & Whitehall St,40.703144,-74.013178,17,28,45
E 118 St & 3 Ave,40.799139,-73.9389152,7,20,27
Winthrop St & Rogers Ave,40.65686,-73.95331,4,14,18
34 Ave & 13 St,40.7638753,-73.9364848,6,13,19
Central Park S & 6 Ave,40.76590936,-73.97634151,36,27,63
6 Ave & Broome St,40.72431,-74.00473,45,24,69
W 16 St & The High Line,40.74334935,-74.00681753,47,7,54
Fulton St & Clermont Ave,40.68415748,-73.96922273,9,65,74
E 27 St & 1 Ave,40.739445,-73.976806,4,82,86
46 Rd & 11 St,40.745805,-73.950752,12,12,24
Van Dam St & Meeker Ave,40.72532,-73.9368,14,13,27
Irving Ave & Harman St,40.70108,-73.9179,7,14,21
St Ann's Ave & Westchester Ave,40.815887,-73.911918,7,9,16
Cooper Square & Astor Pl,40.72951496224949,-73.99075269699097,67,14,81
Astoria Park S & Shore Blvd,40.7767,-73.927631,28,3,31
Myrtle Ave & 65 St,40.70117,-73.8904,10,6,16
S 4 St & Wythe Ave,40.71285887,-73.96590294,26,4,30
St Nicholas Ave & W 150 St,40.827212,-73.942722,0,26,26
35 Ave & 10 St,40.76315481910373,-73.93985509872437,11,14,25
Amsterdam Ave & W 79 St,40.7829391,-73.9786517,11,35,46
New York Ave & Lenox Rd,40.65458,-73.94716,2,21,23
Washington St & Laight St,40.72231,-74.0106,40,23,63
Essex Light Rail,40.7127742,-74.0364857,8,12,20
E 19 St & Beverley Rd,40.64483,-73.9613,16,3,19
Ditmars Blvd & 102 St,40.76894,-73.86832,19,6,25
111 St & Roosevelt Ave,40.75147,-73.8557,16,4,20
W 33 St & 10 Ave,40.753773368360385,-73.99937599897385,6,54,60
Riverside Dr & W 145 St,40.827305,-73.951989,4,24,28
Bedford Park Blvd & Paul Ave,40.87444,-73.89186,12,11,23
President St & Hoyt St,40.680057,-73.991753,19,2,21
Bushwick Ave & Forrest St,40.70076,-73.93641,2,18,20
Prospect Ave & E 167 St,40.826303,-73.898751,9,10,19
Morgan Ave & Lombardy St,40.72226,-73.93889,18,8,26
N 15 St & Wythe Ave,40.724055,-73.955736,50,3,53
41 St & 4 Ave,40.651354,-74.007168,12,5,17
N 5 St & Northside Piers,40.719876,-73.963865,40,2,42
94 St & 57 Ave,40.73628,-73.86752,22,1,23
Empire Blvd & New York Ave,40.66403,-73.94769,13,10,23
34 Ave & 108 St,40.75614,-73.86084,14,7,21
Madison St & Forest Ave,40.70555,-73.90245,6,16,22
Rutland Rd & E 45 St,40.66034,-73.93618,20,0,20
42 Ave & 108 St,40.74944,-73.85792,9,10,19
Bergen Ave & E 152 St,40.817166,-73.914737,9,6,15
57 Rd & 59 St,40.72249,-73.90854,10,6,16
Van Brunt St & Wolcott St,40.6773429,-74.01275056,26,0,26
Prospect Park SW & Greenwood Ave,40.652563,-73.972573,29,1,30
W Broadway & Spring St,40.72494672359416,-74.00165855884552,63,0,63
Amsterdam Ave & W 152 St,40.829523,-73.944279,0,19,19
5 Ave & 41 St,40.649983,-74.005144,14,8,22
E 6 St & Ave D,40.72228087,-73.97668709,13,27,40
23 St & 31 Ave,40.76663971723091,-73.9286595582962,5,12,17
LaGuardia Pl & W 3 St,40.72917025,-73.99810231,41,2,43
Mercer St & Bleecker St,40.72706363348306,-73.99662137031554,53,3,56
E 165 St & Clay Ave,40.82809,-73.91288,10,6,16
Walker St & Baxter St,40.717411,-73.999573,43,2,45
W 17 St & 7 Ave,40.740564236339516,-73.99852573871613,13,34,47
W 204 St & Nagle Ave,40.863211,-73.920827,13,3,16
Harrison St & Hudson St,40.71870987,-74.0090009,14,23,37
Stanton St & Mangin St,40.71782143,-73.97628939,4,10,14
104 St & 38 Ave,40.75138,-73.86242,16,5,21
Morton St & Greenwich St,40.73115,-74.00887,44,10,54
Pacific St & Nevins St,40.6853761,-73.98302136,4,12,16
Grand Concourse & E Mount Eden Ave,40.84301,-73.91172,0,14,14
48 St & Barnett Ave,40.750016404259334,-73.91540944576263,6,8,14
Kingsbridge Terrace & W 230 St,40.87555,-73.90212,10,8,18
E 34 St & Church Ave,40.65116,-73.94577,12,13,25
Rutland Rd & Brooklyn Ave,40.65969,-73.94517,25,0,25
90 St & 51 Ave,40.73937,-73.87411,9,7,16
Front St & Pine St,40.70531,-74.00613,4,45,49
Washington Park,40.6917823,-73.9737299,6,14,20
Madison St & Evergreen Ave,40.69122,-73.91693,5,12,17
Jerome Ave & Bedford Park Blvd E,40.87307,-73.88971,13,10,23
Greenwich Ave & Charles St,40.735238,-74.000271,54,0,54
E 67 St & Park Ave,40.76780080148132,-73.96592080593109,16,21,37
Prospect Park SW & Vanderbilt St,40.65482,-73.973217,21,14,35
N Henry St & Norman Ave,40.7277,-73.94395,8,20,28
Willoughby Ave & Walworth St,40.69331716,-73.95381995,6,7,13
MacDougal St & Prince St,40.72710258,-74.00297088,54,2,56
Broadway & Kent Ave,40.710888,-73.968329,19,9,28
Warren St & Court St,40.686371,-73.99383324,18,5,23
Carlton Ave & Flushing Ave,40.697787,-73.973736,26,15,41
Caton Ave & Argyle Rd,40.649681,-73.967829,14,7,21
Prospect Ave & Vanderbilt St,40.653368,-73.976291,15,5,20
107 St & 32 Ave,40.75996,-73.86224,17,1,18
Willoughby Ave & Onderdonk Ave,40.7098,-73.91727,10,12,22
New York Ave & Montgomery St,40.66509,-73.94824,1,16,17
MacDougal St & Washington Sq,40.73226398,-73.99852205,23,3,26
Greenwich Ave & 8 Ave,40.7390169121,-74.0026376103,70,2,72
Union Ave & N 12 St,40.71924,-73.95242,37,1,38
Courtlandt Ave & E 149 St,40.816402,-73.919549,1,17,18
Madison St & Seneca Ave,40.70183,-73.90625,0,21,21
St James Pl & Pearl St,40.71117416,-74.00016545,21,1,22
56 Ave & 92 St,40.73649,-73.86995,23,0,23
30 St & 48 Ave,40.7413272,-73.937999,20,8,28
Sigourney St & Columbia St,40.67267243410948,-74.0087952464819,13,0,13
Parkside Ave & Flatbush Ave,40.65563,-73.95968,20,4,24
Kingston Ave & Montgomery St,40.66481,-73.94269,7,10,17
Clinton Ave & Myrtle Ave,40.693261,-73.968896,3,23,26
E 39 St & Lexington Ave,40.749498546025194,-73.97729203113158,2,56,58
Andrew Ave N & Hall of Fame Tce,40.85834,-73.91008,2,17,19
W 64 St & Thelonious Monk Circle,40.77515953434235,-73.98918695747852,2,41,43
Warren St,40.7211236,-74.03805095,10,10,20
Bergen St & Mother Gaston Blvd,40.67374,-73.90852,19,4,23
E 161 St & Park Ave,40.824811,-73.916407,12,7,19
Steinway St & 23 Ave,40.7713937,-73.9077436,3,16,19
Evergreen Ave & Noll St,40.70106,-73.93318,11,13,24
1 Ave & E 110 St,40.7923272,-73.9383,20,4,24
3 Ave & E 170 St,40.834857,-73.903743,9,9,18
W 176 St & Montgomery Ave,40.849629,-73.919205,3,15,18
W 51 St & Rockefeller Plaza,40.75973805251143,-73.97811613976955,3,45,48
29 St & 40 Ave,40.75217,-73.93588,1,18,19
Verveelen Pl & Broadway,40.87826,-73.90508,23,0,23
Calyer St & West St,40.72693,-73.95863,30,1,31
Monroe St & Bedford Ave,40.6851443,-73.95380904,4,11,15
E 18 St & Church Ave,40.64958,-73.96316,7,19,26
Jackson St & Leonard St,40.71638031973561,-73.94821286201477,4,15,19
Cortelyou Rd & Albany Ave,40.64483,-73.93853,5,13,18
E 5 St & Ave C,40.72299208,-73.97995466,17,33,50
E 72 St & York Ave,40.76663814,-73.95348296,9,27,36
Fulton St & Williams Ave,40.67709,-73.9008,16,4,20
W 159 St & Edgecombe Ave,40.833303,-73.939326,3,16,19
Edgecombe Ave & W 145 St,40.823498,-73.94386,1,27,28
65 St & 35 Ave,40.75053,-73.8977,14,11,25
Hudson St & W 13 St,40.74005708567285,-74.0052741765976,39,1,40
Greenpoint Ave & Manhattan Ave,40.73026,-73.95394,15,9,24
61 St & Queens Blvd,40.74091,-73.90273,12,13,25
Driggs Ave & Lorimer St,40.72179134,-73.9504154,19,8,27
10 St & 2 Ave,40.671907,-73.993612,13,2,15
Hudson St & N Moore St,40.719887998,-74.0086269379,26,41,67
N 7 St & Driggs Ave,40.716967,-73.956388,28,22,50
57 St & 43 Ave,40.74324,-73.908,7,9,16
1 Ave & E 44 St,40.75001986,-73.96905301,17,65,82
Amsterdam Ave & W 186 St,40.851113,-73.928808,0,18,18
Manila & 1st,40.721650724879986,-74.04288411140442,11,2,13
W 233 St & Albany Crescent,40.87979,-73.90164,19,0,19
Nassau St & Duffield St,40.698477,-73.98384,47,1,48
Anthony Ave & E Tremont Ave,40.848793,-73.903178,3,13,16
72 St & Broadway,40.74751,-73.89372,12,8,20
53 St & 2 Ave,40.64744,-74.018846,27,0,27
W 129 St & Convent Ave,40.814394437915816,-73.95324736833572,15,13,28
Washington St & Barrow St,40.73191132323174,-74.008769094944,42,11,53
St Johns Pl & Kingston Ave,40.67113,-73.94222,7,13,20
W 49 St & 8 Ave,40.76227205,-73.98788205,3,62,65
Crotona Pkwy & Bronx Park S,40.84784,-73.883,10,9,19
Throop Ave & Myrtle Ave,40.69622937,-73.94371094,0,20,20
Liberty Light Rail,40.7112423,-74.0557013,8,11,19
Broadway & Whipple St,40.7016657,-73.9437303,17,8,25
1 Ave & E 30 St,40.74144387,-73.97536082,11,26,37
Delancey St & Eldridge St,40.719383,-73.991479,24,2,26
Devoe St & Morgan Ave,40.713811,-73.93515,9,8,17
Broadway & W 37 St,40.75172632,-73.98753523,13,44,57
46 St & 28 Ave,40.763328,-73.908782,6,11,17
Monroe St & Marcus Garvey Blvd,40.686722,-73.938988,1,18,19
Forsyth St & Broome St,40.71893904,-73.99266288,54,3,57
51 St & Hobart St,40.75767234025041,-73.90769943594933,5,16,21
Montgomery St & Franklin Ave,40.666439306870814,-73.9605563879013,13,6,19
Eastern Pkwy & Rochester Ave,40.66846,-73.9282,6,17,23
Van Sinderen Ave & Truxton St,40.6786,-73.90369,2,20,22
W 42 St & Dyer Ave,40.75898481399634,-73.99379968643188,9,19,28
Knickerbocker Ave & George St,40.704425,-73.92836,19,3,22
39 St & 50 Ave,40.73824937345944,-73.92737478017807,9,8,17
S 3 St & Bedford Ave,40.71260486,-73.96264403,5,16,21
Van Buren St & Broadway,40.692,-73.92617,1,18,19
47 Ave & 109 St,40.74713,-73.85502,17,10,27
46 St & 25 Ave,40.765753,-73.90676,2,18,20
Albany St & Greenwich St,40.709267,-74.013247,12,22,34
St Marks Ave & Rochester Ave,40.67404,-73.92772,0,20,20
Lenox Ave & W 111 St,40.7987859,-73.9523,6,27,33
Skillman Ave & Honeywell St,40.747148249032804,-73.92902433872223,9,9,18
Jackson Ave & 49 Ave,40.7429302,-73.952037,26,2,28
60 Pl & Flushing Ave,40.71988,-73.90556,13,4,17
Garrison Ave & Manida St,40.818743,-73.890247,20,10,30
31 St & Ditmars Blvd,40.776168,-73.910485,19,2,21
Knickerbocker Ave & Moffat St,40.690434,-73.903737,9,12,21
Grant Ave & MLK Dr,40.70919832245443,-74.08084273338318,15,2,17
W 15 St & 10 Ave,40.742753828659026,-74.00747358798981,47,6,53
2 Ave & 32 St,40.659176,-74.006584,24,0,24
74 St & 37 Ave,40.74908,-73.89172,8,21,29
McKibbin St & Bogart St,40.706237,-73.933871,23,5,28
Inwood Ave & W 170 St,40.840536,-73.919228,17,0,17
Jay St & Tech Pl,40.695065,-73.987167,12,35,47
Stephen St & Seneca Ave,40.6988,-73.9007,2,11,13
E 103 St & Lexington Ave,40.7903051,-73.94755757,19,13,32
5 Ave & 37 St,40.652657,-74.002356,23,2,25
Central Park W & W 103 St,40.79558954105342,-73.96188408136368,7,32,39
Grand Concourse & E 144 St,40.816576,-73.927987,13,9,22
Broadway & W 234 St,40.88185,-73.90291,24,0,24
E 165 St & Fox St,40.82394,-73.894025,12,13,25
Lenox Ave & W 144 St,40.819783,-73.936521,7,8,15
Lenox Ave & W 115 St,40.8011939,-73.9500739,12,17,29
E 174 St & Walton Ave,40.844811,-73.912042,10,17,27
98 St & 41 Ave,40.74773,-73.86649,10,8,18
Tiebout Ave & E 184 St,40.858498,-73.89637,2,13,15
MacDonough St & Marcy Ave,40.68078,-73.94613,2,13,15
Barry St & Tiffany St,40.816126,-73.891559,16,3,19
Parkside Ave & Ocean Ave,40.65485,-73.96217,18,4,22
56 Ave & Junction Blvd,40.73716,-73.86625,12,7,19
Jerome Ave & W 195 St,40.86874,-73.89657,10,20,30
Cauldwell Ave & E 161 St,40.82188,-73.907521,9,8,17
Caton Ave & St. Pauls Pl,40.65153,-73.96277,6,14,20
Kenmare St & Elizabeth St,40.72054,-73.9949,31,5,36
Court St & State St,40.6902375,-73.99203074,3,26,29
Ditmars Blvd & 48 St,40.769219,-73.901001,7,9,16
Union St & Bedford Ave,40.6691783,-73.9554162,4,15,19
Hazen St & 20 Ave,40.772092,-73.895166,21,2,23
Congress St & Hicks St,40.6893952,-73.9995126,24,6,30
103 St & 41 Ave,40.74875,-73.86285,21,2,23
Eastern Pkwy & Nostrand Ave,40.66967,-73.9503,6,20,26
Hancock St & Stuyvesant Ave,40.68454,-73.9322,11,4,15
40 St & 3 Ave,40.6535,-74.00902,28,1,29
72 St & Northern Blvd,40.75473,-73.89458,5,11,16
57 St & 37 Ave,40.75048,-73.90513,9,10,19
Main St & Plymouth St,40.703781673548306,-73.99073392152786,35,3,38
East End Ave & E 86 St,40.77518615,-73.94446054,5,20,25
Elmhurst Ave & Roosevelt Ave,40.74864,-73.87619,6,13,19
W 67 St & Broadway,40.77492513,-73.98266566,17,2,19
E 182 St & Park Ave,40.85455,-73.89507,20,2,22
Sedgwick Ave & W 195 St,40.87049,-73.90287,11,8,19
Willoughby Ave & Wyckoff Ave,40.705614,-73.92153,11,9,20
Broadway & W 138 St,40.82182,-73.95353,3,16,19
Mercer St & Spring St,40.72362738,-73.99949601,64,2,66
31 Ave & 86 St,40.75958,-73.88219,9,7,16
32 Ave & 77 St,40.75727,-73.89024,15,8,23
Eastern Pkwy & Franklin Ave (NE Corner),40.6707767,-73.9576801,16,21,37
W 113 St & Broadway,40.805973,-73.964928,3,26,29
W 47 St & 9 Ave,40.76153045158114,-73.99007007479668,14,34,48
Van Cortlandt Park S & Gouverneur Ave,40.88492,-73.89084,2,22,24
E 106 St & Lexington Ave,40.791976,-73.945993,19,7,26
Communipaw & Berry Lane,40.71435836870427,-74.06661093235016,10,1,11
E 170 St & Webster Ave,40.83617913677475,-73.90730146322765,12,13,25
Queens Blvd & 56 Ave,40.73481,-73.87431,30,3,33
Central Ave & Woodbine St,40.69296,-73.91605,1,15,16
E 118 St & Park Ave,40.8005385,-73.9419949,7,17,24
Ditmars Blvd & 43 St,40.771203,-73.903865,7,15,22
64 St & Woodbine St,40.70809,-73.89549,4,14,18
Court St & Nelson St,40.6763947,-73.99869893,16,11,27
Clinton St & Joralemon St,40.69239502,-73.99337909,18,21,39
Adelphi St & Myrtle Ave,40.69308257,-73.97178913,11,11,22
Rutgers St & Henry St,40.71332151208186,-73.99009689688683,26,11,37
E 115 St & Madison Ave,40.7989445,-73.944846,20,4,24
E 201 St & Briggs Ave,40.87207,-73.88459,12,2,14
Barrow St & Hudson St,40.73172428,-74.00674436,31,2,33
Prospect Park W & 20 St,40.656633,-73.983864,3,22,25
43 Ave & 42 St,40.74534682580983,-73.9219419658184,7,16,23
Metropolitan Ave & Stewart Ave,40.71401,-73.92793,15,3,18
Knickerbocker Ave & Thames St,40.70539,-73.92976,16,2,18
10 Ave & W 204 St,40.862638,-73.92006,11,5,16
Cathedral Pkwy & Broadway,40.804213,-73.96699104,1,22,23
Myrtle Ave & Grove St,40.69905,-73.91516,10,10,20
Dyckman St & Staff St,40.868846,-73.931537,15,3,18
5 Ave & E 72 St,40.77282817,-73.96685276,26,0,26
5 Ave & 44 St,40.64865,-74.00646,11,12,23
South Railroad Ave & Broadway,40.741,-73.88027,17,5,22
S 4 St & Rodney St,40.70934,-73.95608,16,4,20
34 Ave & 83 St,40.753935004830225,-73.88390148299196,7,12,19
W 190 St & Broadway,40.85648733523576,-73.93296986818314,6,15,21
Adam Clayton Powell Blvd & W 132 St,40.813539,-73.94521,9,11,20
76 St & 21 Ave,40.77028,-73.893675,15,6,21
Allen St & Rivington St,40.72019576,-73.98997825,24,16,40
Boston Rd & E 178 St,40.84096,-73.87923,20,2,22
Grove St PATH,40.71941,-74.04309,24,16,40
Brevoort Pl & Bedford Ave,40.68012,-73.95362,2,19,21
Union St & 4 Ave,40.6772744,-73.98282002,23,2,25
E 51 St & 1 Ave,40.75455731,-73.96592976,2,26,28
McKeever Pl & Sullivan Pl,40.66432331577469,-73.95921791486467,4,14,18
E 8 St & Caton Ave,40.648055,-73.972432,21,2,23
21 St & 20 Ave,40.78393602019729,-73.91273114065842,4,13,17
Dean St & Rockaway Ave,40.67486,-73.91123,16,5,21
Suydam St & St Nicholas Ave,40.70636,-73.91945,5,10,15
Borden Ave & 25 St,40.7396139,-73.945151,14,12,26
Grove St & Broadway,40.69047,-73.923511,13,16,29
Greenwich St & Perry St,40.73498,-74.00697,18,25,43
53 St & Roosevelt Ave,40.74462,-73.91143,0,16,16
W 181 St & Riverside Dr,40.85168,-73.94186,4,13,17
Bushwick Ave & Furman Ave,40.68281,-73.90623,10,18,28
Lafayette St & Jersey St,40.72456089,-73.99565293,48,5,53
53 Ave & 62 St,40.73169,-73.90159,18,1,19
54 St & 37 Ave,40.75098,-73.90799,14,10,24
Schenectady Ave & President St,40.66732,-73.93398,8,12,20
77 St & 24 Ave,40.76428,-73.89156,14,1,15
Columbus Ave & W 59 St,40.76931,-73.98464,2,36,38
Maple St & New York Ave,40.66104,-73.94795,19,2,21
Suydam St & Knickerbocker Ave,40.702013,-73.923769,16,11,27
Brooklyn Ave & Tilden Ave,40.64725,-73.94352,11,12,23
Lafayette Ave & Ft Greene Pl,40.68700231292619,-73.97664964199066,17,11,28
Central Ave & Covert St,40.68929,-73.90951,17,12,29
Steinway St & 21 Ave,40.774798,-73.903787,3,16,19
Bushwick Ave & Linden St,40.69146,-73.92146,10,15,25
64 St & 51 Ave,40.73577,-73.90184,17,0,17
E 102 St & 1 Ave,40.7869946,-73.94164802,5,18,23
Walnut Ave & E 136 St,40.801657,-73.909513,10,4,14
5 Ave & W 131 St,40.81014,-73.93973,6,13,19
State St & Smith St,40.68917,-73.9886,59,5,64
Albany Ave & Park Pl,40.67297,-73.93896,3,15,18
Bailey Ave & W 193 St,40.87069,-73.90678,17,1,18
River Ave & E 153 St,40.82441,-73.92818,24,3,27
Clinton St & 4 Place,40.6783563,-74.00014502,16,7,23
7 St & 3 Ave,40.67260298150126,-73.98983001708984,15,4,19
W Fordham Rd & Loring Pl N,40.86295,-73.90741,11,8,19
W 27 St & 6 Ave,40.74526,-73.99062,11,50,61
E 12 St & Ave C,40.727243,-73.976831,9,30,39
Amsterdam Ave & W 175 St,40.844044,-73.933651,11,7,18
6 Ave & 9 St,40.668127,-73.98377641,22,4,26
Clarkson Ave & E 37 St,40.65577,-73.9432,3,19,22
Corona Ave & 92 St,40.7424,-73.87251,16,0,16
E 26 St & 3 Ave,40.74069317733043,-73.98160636425018,1,36,37
3 Ave & E 82 St,40.775744,-73.9563752,25,13,38
Lorimer St & Broadway,40.70411791,-73.94818595,0,29,29
6 St & 7 Ave,40.6686627,-73.97988067,1,12,13
Tilden Ave & Lott St,40.64661,-73.95401,17,0,17
31 St & Astoria Blvd,40.7699176,-73.9184057,3,24,27
Frederick Douglass Blvd & W 139 St,40.81900581806558,-73.94476890563965,9,13,22
E 27 St & Park Ave S,40.74275179648995,-73.9847157150507,6,57,63
E 17 St & Beverley Rd,40.64466,-73.96322,17,3,20
Fulton St & Broadway,40.711066,-74.009447,9,34,43
3 St & Prospect Park West,40.668132,-73.97363831,29,0,29
Carmine St & 6 Ave,40.73038599,-74.00214988,63,0,63
W 35 St & Dyer Ave,40.754691750226016,-73.99740189313889,0,39,39
Metropolitan Ave & Bedford Ave,40.71534825,-73.96024116,29,20,49
Harman St & Seneca Ave,40.70577,-73.91292,3,13,16
Page Pl & Grand Ave,40.71798,-73.91818,15,4,19
Cadman Plaza E & Tillary St,40.69597683,-73.99014892,31,13,44
Madison St & Woodward Ave,40.70408,-73.90408,1,17,18
Frederick Douglass Blvd & Harlem River Dr,40.830702,-73.936371,11,4,15
Pacific St & Ralph Ave,40.67607,-73.92171,0,17,17
6 Ave & W 34 St,40.74964,-73.98805,32,31,63
Milton St & Franklin St,40.72906,-73.95779,28,2,30
Ave A & E 11 St,40.72854745023944,-73.98175925016403,23,34,57
W 90 St & Amsterdam Ave,40.79018,-73.97289,3,27,30
7 Ave & 20 St,40.659053,-73.98854,8,11,19
E 103 St & 2 Ave,40.78864,-73.9436,13,18,31
30 Ave & 12 St,40.771717105208275,-73.93159255385399,16,17,33
Catalpa Ave & Woodward Ave,40.70229,-73.90145,5,13,18
E 31 St & 3 Ave,40.74394314,-73.97966069,6,57,63
Broadway & Berry St,40.71036129922581,-73.96530389785767,25,8,33
Pearl St & Hanover Square,40.7047177,-74.00926027,14,46,60
2 Ave & E 99 St,40.7862586,-73.94552579,27,4,31
20 Ave & 48 St,40.772899,-73.896849,22,0,22
Bond St & Bergen St,40.6849668,-73.98620772,16,4,20
Stockholm St & Wilson Ave,40.699304,-73.923044,7,16,23
67 St & Erik Pl,40.633385,-74.016562,20,1,21
57 Rd & 58 St,40.72235,-73.91215,19,2,21
Carlton Ave & St Marks Ave,40.67911856082165,-73.97176265716553,17,5,22
Graham Ave & Withers St,40.7169811,-73.94485918,3,14,17
Jerome Ave & E Mosholu Pkwy S,40.87935,-73.88534,19,0,19
44 St & 48 Ave,40.73941387498411,-73.92131969332695,4,17,21
E 181 St & Bathgate Ave,40.85198,-73.89438,12,3,15
Martense Ave & 108 St,40.74214,-73.85418,10,10,20
Journal Square,40.73367,-74.0625,4,13,17
Adams St & Prospect St,40.700763083261506,-73.98869812488556,57,0,57
Eliot Ave & 60 Ln,40.71391,-73.90299,7,13,20
Tinton Ave & E 165 St,40.824796,-73.90242,2,13,15
24 Ave & 26 St,40.774591,-73.918544,8,10,18
Troy Ave & Linden Blvd,40.6533,-73.93644,18,4,22
W 171 St & St Nicholas Ave,40.842941,-73.938631,4,24,28
36 St & 47 Ave,40.742218349960964,-73.92935156822205,5,13,18
Pacific St & Troy Ave,40.67686,-73.93607,8,12,20
E 153 St & E 157 St,40.826677,-73.929327,19,0,19
W 87 St & Amsterdam Ave,40.78839,-73.9747,4,33,37
Clarkson Ave & Troy Ave,40.65633,-73.93648,18,5,23
31 St & Newtown Ave,40.7675487799971,-73.9209334552288,19,16,35
Engert Ave & McGuinness Blvd,40.72158,-73.94546,8,11,19
Driggs Ave & N 9 St,40.71816969454208,-73.95520135760307,38,13,51
48 St & Broadway,40.755763,-73.912715,7,22,29
W 10 St & Washington St,40.73342399437081,-74.00851495563984,53,8,61
57 St & 7 Ave,40.638566,-74.010147,6,9,15
8 Ave & W 24 St,40.74591072834279,-73.99807110428809,9,23,32
Monroe St & Tompkins Ave,40.686203,-73.944694,5,12,17
Union Ave & Jackson St,40.7160751,-73.952029,14,5,19
Front St & Gold St,40.70224,-73.982578,29,4,33
Crescent St & 30 Ave,40.768692,-73.9249574,0,21,21
19 St & 8 Ave,40.658489,-73.985543,0,22,22
102 St & 34 Ave,40.75584,-73.86621,3,15,18
W 180 St & Fort Washington Ave,40.849972,-73.938423,18,6,24
Columbia St & Lorraine St,40.6747055,-74.0075572,36,0,36
Brook Ave & E 141 St,40.809619,-73.917875,12,6,18
Grand Concourse & E 176 St,40.84761,-73.90745,7,15,22
Brooklyn Bridge Park - Pier 2,40.698458,-73.997178,23,6,29
West End Ave & W 94 St,40.7941654,-73.974124,8,14,22
E 19 St & 3 Ave,40.73624527,-73.98473765,8,25,33
Ditmars Blvd & 31 Dr,40.76138,-73.86035,24,4,28
Leonard St & Maujer St,40.7103685423523,-73.94705951213837,6,18,24
Fort Washington Ave & W 190 St,40.856906,-73.935662,6,11,17
E 163 St & Tiffany St,40.821075,-73.895069,17,1,18
Oakland Ave,40.7376037,-74.0524783,11,13,24
W 26 St & 10 Ave,40.749717753,-74.002950346,11,27,38
W 47 St & 6 Ave,40.758397,-73.98255,14,45,59
E 58 St & 1 Ave (NW Corner),40.759125,-73.962658,12,34,46
5 Ave & E 30 St,40.7459849,-73.98629487,23,32,55
Scholes St & Lorimer St,40.708323,-73.948732,7,20,27
100 St & Northern Blvd,40.75748,-73.86843,9,10,19
Amsterdam Ave & W 172 St,40.842173,-73.935111,10,8,18
Southern Blvd & Tiffany St,40.818185,-73.894143,13,1,14
47 Ave & 104 St,40.7458,-73.85945,15,5,20
Carroll St & Smith St,40.680611,-73.99475825,37,3,40
E 10 St & Ave A,40.72740794,-73.98142006,43,63,106
South End Ave & Albany St,40.709957,-74.016538,19,18,37
Dwight St & Dikeman St,40.67487503856169,-74.01048018571481,15,0,15
Montgomery St,40.71942,-74.05099,11,0,11
Douglass St & 4 Ave,40.6792788,-73.98154004,46,3,49
President St & Nostrand Ave,40.66811,-73.9505,1,22,23
FDR Drive & E 35 St,40.744219,-73.97121214,22,99,121
Hamilton Pl & W 140 St,40.822756,-73.951346,0,13,13
7 Ave & 22 St,40.658029,-73.989605,16,5,21
Sedgwick Ave & W Tremont Ave,40.85304455868985,-73.91830623149872,5,13,18
Convent Ave & W 151 St,40.82831,-73.942924,1,20,21
Grand Ave & 58 Ave,40.72098,-73.90701,18,1,19
E 158 St & Melrose Ave,40.822215,-73.914688,7,14,21
Jerome Ave & W 184 St,40.860814,-73.902541,15,0,15
39 Ave & 99 St,40.74962,-73.86677,1,20,21
Willis Ave & Bruckner Blvd,40.805701,-73.925177,5,12,17
Convent Ave & W 135 St,40.818215,-73.950988,1,28,29
Brooklyn Ave & Dean St,40.67669,-73.94437,3,12,15
30 Ave & 47 St,40.761294,-73.909562,1,18,19
Southern Blvd & E 187 St,40.8535,-73.88177,8,12,20
E 93 St & 2 Ave,40.782454175279874,-73.9489196240902,64,5,69
Monmouth & 6th,40.72568548362901,-74.04879033565521,5,9,14
Church Sq Park - 5 St & Park Ave,40.74265933273143,-74.03223305940628,7,11,18
Adams St & 2 St,40.73981372311843,-74.03690412640572,3,11,14
Sterling Pl & Bedford Ave,40.672695,-73.954131,0,23,23
3 Ave & 14 St,40.6685455,-73.99333264,21,4,25
Broadway & 12 St,40.7668,-73.9347774,19,12,31
9 Ave & W 204 St,40.86169883507865,-73.91855701804161,19,3,22
Elmhurst Ave & Forley St,40.74615,-73.87763,5,16,21
Corona Ave & 90 St,40.74154,-73.87484,9,12,21
99 St & 58 Ave,40.73761,-73.85959,14,11,25
9 Ave & W 18 St,40.74317449,-74.00366443,73,2,75
Pacific St & Rochester Ave,40.67639,-73.92748,5,10,15
23 Rd & 31 St,40.77336750284339,-73.91382560133934,5,13,18
Kosciuszko St & Nostrand Ave,40.69072549,-73.95133465,12,9,21
North Moore St & Greenwich St,40.72019521437465,-74.0103006362915,19,4,23
N 11 St & Kent Ave,40.72248188638219,-73.95921930670738,23,1,24
Townsend Ave & E 175 St,40.84741,-73.911359,15,0,15
Lorimer St & Harrison Ave,40.702726,-73.94984,13,5,18
W 44 St & 11 Ave,40.762009,-73.996975,2,68,70
Nelson Ave & 167 St,40.83670566862804,-73.92608866095543,5,10,15
Bedford Ave & Clarkson Ave,40.65519,-73.9564,8,5,13
Railroad Ave & Kay Ave,40.70514807698391,-73.97078096866608,18,12,30
N Portland Ave & Flushing Ave,40.697926,-73.97663,17,14,31
47 St & 3 Ave,40.649143,-74.012384,20,2,22
E 13 St & 2 Ave,40.73153937464073,-73.9853024482727,26,26,52
91 St & 31 Ave,40.76022,-73.87774,14,5,19
Cypress Ave & Palmetto St,40.701573408737914,-73.90876293182373,0,24,24
E 167 St & Franklin Ave,40.82895,-73.90521,3,11,14
Lafayette Ave & Franklin Ave,40.689271,-73.957324,6,20,26
Tibbett Ave & W 234 St,40.88324,-73.90587,18,1,19
31 Ave & 103 St,40.76134,-73.86666,3,17,20
61 St & Woodside Ave,40.74501,-73.9036,15,1,16
E 58 St & 3 Ave,40.76095756,-73.96724467,6,43,49
6 Ave & 12 St,40.6663181,-73.9854617,12,13,25
Eldert St & Bushwick Ave,40.68652,-73.91321,7,13,20
W 95 St & Broadway,40.7937704,-73.971888,4,22,26
W 37 St & Broadway,40.75227093837409,-73.98770570755005,9,71,80
12 St & 4 Ave,40.668603,-73.9904394,18,3,21
Central Park S & Grand Army Plaza,40.764555,-73.973473,5,78,83
Lewis Ave & Kosciuszko St,40.69237074,-73.93705428,6,15,21
Morris Canal,40.7124188237569,-74.03852552175522,10,1,11
51 St & Queens Blvd,40.7429,-73.91395,3,16,19
E 91 St & 2 Ave,40.781152764279156,-73.94963040947914,60,9,69
51 Ave & 61 St,40.73568,-73.90387,16,2,18
Wilkins Ave & Crotona Park E,40.835302,-73.895133,8,8,16
65 St & Roosevelt Ave,40.74589,-73.89915,10,18,28
Riverside Dr E & W 155 St,40.834097985815255,-73.94834974194816,5,11,16
Henry St & Middagh St,40.7003,-73.991581,19,14,33
E 50 St & Park Ave,40.757334,-73.974235,13,21,34
Crescent St & Ditmars Blvd,40.7787185,-73.9145645,7,11,18
Thompson St & Bleecker St,40.72840059450829,-73.99968780577183,57,1,58
Banker St & Meserole Ave,40.72606,-73.95621,27,1,28
51 St & 43 Ave,40.74451,-73.91412,2,24,26
Sterling Pl & 5 Ave,40.678970070475735,-73.97855266928671,17,3,20
Pioneer St & Richards St,40.6777748,-74.0094613,21,0,21
Turner Pl & Coney Island Ave,40.64521,-73.97073,16,3,19
Concord St & Bridge St,40.69766564,-73.98476437,3,11,14
Greenwood Ave & E 4 St,40.650739,-73.977739,5,15,20
Greenwich St & Hubert St,40.721319,-74.010065,13,16,29
34 Ave & 48 St,40.75388,-73.914952,12,9,21
N 6 St & Bedford Ave,40.71745169,-73.95850939,25,2,27
Stewart Ave & Johnson Ave,40.70869,-73.92587,16,0,16
Crown St & Troy Ave,40.66559,-73.93712,3,16,19
E 80 St & 2 Ave,40.77391390238118,-73.9543953537941,6,25,31
Bushwick Ave & McKibbin St,40.705517,-73.93936,4,16,20
Ditmars Blvd & 76 St,40.768442,-73.893531,8,9,17
Pitkin Ave & Grafton St,40.66852,-73.91908,0,21,21
56 Dr & 59 St,40.72403,-73.90853,16,3,19
Sterling Pl & Franklin Ave,40.67324785,-73.95689517,3,11,14
46 Ave & 5 St,40.74731,-73.95451,39,2,41
30 Ave & 96 St,40.76086,-73.87308,16,3,19
Stagg St & Morgan Ave,40.710681,-73.93372,23,0,23
60 Ave & Fresh Pond Rd,40.71693,-73.90198,9,9,18
Greene Ave & Nostrand Ave,40.6883337,-73.950916,3,19,22
Woodside Ave & 69 St,40.7428,-73.89584,1,16,17
Southpoint Park,40.75370225419114,-73.95865201950072,31,3,34
49 Ave & 108 St,40.74535,-73.8558,19,3,22
W 29 St & 9 Ave,40.7500727,-73.99839279,6,37,43
W 52 St & 6 Ave,40.76132983124814,-73.97982001304626,22,37,59
Lewis Ave & Madison St,40.686312,-73.935775,1,19,20
Hoboken Ave at Monmouth St,40.73520838045357,-74.04696375131607,12,20,32
Taylor St & Bedford Ave,40.705774,-73.963252,12,11,23
Hamilton Park,40.727595966,-74.044247311,20,4,24
Willis Ave & E 141 St,40.81093,-73.921606,8,5,13
E 81 St & Park Ave,40.77677702,-73.9590097,16,22,38
Whitney Ave & Ketcham Pl,40.74249,-73.87809,10,12,22
10 Ave & W 14 St,40.741981599940225,-74.00831580162048,66,5,71
W 144 St & Adam Clayton Powell Blvd,40.820877,-73.939249,6,15,21
E 9 St & 5 Ave,40.73275887045087,-73.99581670761108,48,7,55
Echo Pl & Grand Concourse,40.849955,-73.905943,12,14,26
Vesey St & Church St,40.71221958009051,-74.01047229766846,6,66,72
E 191 St & Bathgate Ave,40.8601,-73.8866,24,3,27
Amsterdam Ave & W 82 St,40.78524672,-73.97667321,10,24,34
Lenox Ave & W 117 St,40.8025566,-73.9490782,16,12,28
Ashland Pl & Dekalb Ave,40.690065,-73.978776,28,15,43
10 Ave & W 207 St,40.864632,-73.918598,22,15,37
Willoughby Ave & Tompkins Ave,40.69425403,-73.94626915,2,16,18
Sterling Pl & Rochester Ave,40.67128,-73.92825,7,13,20
Vesey St & Greenwich St,40.71254669463547,-74.01113051087516,19,87,106
Davis St & Jackson Ave,40.745627,-73.945661,13,21,34
Old Slip & South St,40.70336686695866,-74.007867872715,73,16,89
Beverley Rd & Nostrand Ave,40.64507,-73.9488,18,2,20
E 84 St & 1 Ave,40.77565541,-73.95068615,7,18,25
Bedford Ave & Albemarle Rd,40.64796,-73.9556,12,1,13
W 165 St & Fort Washington Ave,40.84004,-73.942939,1,24,25
11 Ave & W 59 St,40.77149671054441,-73.99046033620834,1,14,15
Broadway & W 25 St,40.74286877312112,-73.98918628692627,15,89,104
Hilltop,40.7311689,-74.0575736,5,19,24
E 115 St & Lexington Ave,40.797911,-73.9423,24,0,24
E 88 St & 1 Ave,40.778301,-73.9488134,18,10,28
55 St & Northern Blvd,40.75326,-73.90585,9,13,22
Sunken Meadow Comfort Station,40.79558,-73.91906,10,14,24
29 St & Skillman Ave,40.744831,-73.938411,8,17,25
Metropolitan Ave & Meeker Ave,40.71413311,-73.95234386,19,8,27
Manhattan Ave & Leonard St,40.72084,-73.94844,13,4,17
6 Ave & 60 St,40.638196,-74.013821,18,0,18
Crotona Park North & Prospect Ave,40.841092,-73.892317,2,17,19
11 Ave & W 27 St,40.751396,-74.005226,5,36,41
South St & Broad St,40.70188858913366,-74.01089876890182,24,7,31
W 192 St & University Ave,40.866899,-73.901942,7,13,20
114 St & 39 Ave,40.7532,-73.853,29,0,29
Buffalo Ave & St John's Pl,40.67015,-73.92538,4,17,21
Carroll St & Columbia St,40.6830456,-74.00348559,34,4,38
W 11 St & 6 Ave,40.73532427,-73.99800419,46,29,75
Dyckman St & 10 Ave,40.85890447538412,-73.9230939745903,9,7,16
Lexington Ave & E 128 St,40.806414,-73.936085,17,4,21
Maurice Ave & 53 Dr,40.73028,-73.90421,14,0,14
Steinway St & 19 Ave,40.778089,-73.899558,17,2,19
DeKalb Ave & Vanderbilt Ave,40.68940747,-73.96885458,6,10,16
16 St & 4 Ave,40.666197,-73.992466,23,6,29
Division Ave & Hooper St,40.70684203101325,-73.9544353965357,20,39,59
N 10 St & Berry St,40.720253,-73.957082,29,15,44
McDonald Ave & Vanderbilt St,40.651654,-73.981231,18,2,20
E 180 St & Prospect Ave,40.84696,-73.88663,7,15,22
Frederick Douglass Blvd & W 112 St,40.801694,-73.957145,9,22,31
21 Ave & Crescent St,40.780478,-73.912212,0,16,16
Canal St & Rutgers St,40.71427487,-73.98990025,30,8,38
E 116 St & 2 Ave,40.796879,-73.937261,22,7,29
University Pl & E 8 St,40.73143724085228,-73.99490341544151,33,27,60
Bainbridge Ave & E 196 St,40.86648,-73.89042,14,4,18
Cooper Ave & 65 Pl,40.69953,-73.88873,10,12,22
Wadsworth Ave & W 179 St,40.848467,-73.936064,6,24,30
Glenwood Ave,40.72755146730012,-74.07106071710587,11,5,16
50 St & 30 Ave,40.760083,-73.907107,4,19,23
34 St & 4 Ave,40.655278,-74.003101,21,0,21
74 St & Woodside Ave,40.74325,-73.89079,5,12,17
St Felix Ave & 61 St,40.69715,-73.8936,4,13,17
2 Ave & E 125 St,40.802554,-73.933509,23,1,24
Pier 40 - Hudson River Park,40.7277140777778,-74.01129573583603,14,3,17
60 Pl & Bleecker St,40.71107,-73.903,1,15,16
47 Ave & Skillman Ave,40.7437524099784,-73.94176483154297,10,9,19
Columbus Ave & W 72 St,40.7770575,-73.97898475,34,27,61
E 138 St & Willow Ave,40.804168,-73.911545,17,1,18
Dean St & Franklin Ave,40.67759206937376,-73.955637216568,9,11,20
E 149 St & Morris Ave,40.81734,-73.922962,12,17,29
58 St & 32 Ave,40.75574,-73.903427,5,12,17
